,분류,관광지명,주소,10월,9월,8월,전체조회수,평균조회수
377,관광지,비자림,제주특별자치도 제주시 구좌읍 비자숲길 55,10979,9288,10699,30966,10322
393,관광지,사려니숲길,제주특별자치도 제주시 조천읍 교래리 산 137-1,10374,8501,10873,29748,9916
478,관광지,성산일출봉(UNESCO 세계자연유산),제주특별자치도 서귀포시 성산읍 일출로 284-12,11845,8708,6826,27379,9126
682,관광지,우도(해양도립공원),제주특별자치도 제주시 우도면 삼양고수물길 1,10117,7765,8417,26299,8766
259,관광지,만장굴,제주특별자치도 제주시 구좌읍 만장굴길 182,6757,5999,9713,22469,7490
427,관광지,새별오름,제주특별자치도 제주시 애월읍 봉성리 산 59-8,9905,6028,4071,20004,6668
957,관광지,천지연폭포,제주특별자치도 서귀포시 남성중로 2-15,4340,3868,4847,13055,4352
1065,관광지,함덕해수욕장,제주특별자치도 제주시 조천읍 조함해안로 519-10,2645,2269,7057,11971,3990
1086,관광지,협재해수욕장,제주특별자치도 제주시 한림읍 한림로 329-10,2741,2338,6532,11611,3870
470,관광지,섭지코지,제주특별자치도 서귀포시 성산읍 섭지코지로 107,4252,3347,3490,11089,3696
1212,쇼핑,제주민속오일시장,제주특별자치도 제주시 오일장서길 26,5039,3423,2337,10799,3600
675,관광지,용머리해안,제주특별자치도 서귀포시 안덕면 사계리,4787,2057,3117,9961,3320
523,관광지,쇠소깍,제주특별자치도 서귀포시 쇠소깍로 128,4649,1595,2724,8968,2989
919,관광지,주상절리대(중문대포해안),제주특별자치도 서귀포시 이어도로 36-30,2702,2171,3547,8420,2807
1135,쇼핑,동문재래시장,제주특별자치도 제주시 관덕로14길 20,1570,2608,4235,8413,2804
1011,관광지,판포포구,제주특별자치도 제주시 한경면 판포리 2877-3,420,1337,6324,8081,2694
1102,관광지,황우지해안,제주특별자치도 서귀포시 서홍동 766-1,1075,2129,4808,8012,2671
1050,관광지,한라산영실코스,제주특별자치도 서귀포시 영실로 246,3411,1537,2167,7115,2372
823,관광지,제주아트서커스,제주특별자치도 서귀포시 안덕면 동광로 214,1003,2138,3239,6380,2127
101,관광지,금능해수욕장,제주특별자치도 제주시 한림읍 금능길 119-10,982,1195,4194,6371,2124
20,관광지,가파도,제주특별자치도 서귀포시 대정읍 가파리,1970,2030,2275,6275,2092
976,관광지,카멜리아힐,제주 서귀포시 안덕면 병악로 166,2374,1934,1933,6241,2080
753,관광지,정방폭포,제주특별자치도 서귀포시 칠십리로214번길 37,2121,1888,2200,6209,2070
346,관광지,보롬왓,제주특별자치도 서귀포시 표선면 번영로 2350-104,1305,1603,3187,6095,2032
119,관광지,김녕해수욕장,제주특별자치도 제주시 구좌읍 구좌해안로 237,1615,1015,3301,5931,1977
396,관광지,산굼부리,제주특별자치도 제주시 조천읍 비자림로 768,2325,1692,1847,5864,1955
518,관광지,송악산,제주특별자치도 서귀포시 대정읍 송악관광로 421-1,3003,1148,1640,5791,1930
607,관광지,애월한담해안산책로,제주특별자치도 제주시 애월읍 곽지리 1359,2180,1587,1841,5608,1869
398,관광지,산방산,제주특별자치도 서귀포시 안덕면 사계리 산 16,2559,1125,1781,5465,1822
1047,관광지,한라산국립공원,제주특별자치도 제주시 1100로 2070-61,2244,1663,1473,5380,1793
707,관광지,월정리해변,제주특별자치도 제주시 구좌읍 월정리 33-3,1498,1536,2268,5302,1767
733,관광지,이호테우해수욕장,제주특별자치도 제주시 도리로 20,2173,683,2368,5224,1741
926,관광지,중문색달해수욕장,제주특별자치도 서귀포시 중문관광로72번길 29-51,965,865,3363,5193,1731
171,관광지,닭머르해안길,제주특별자치도 제주시 조천읍 신촌북3길 62-1,2589,1427,1034,5050,1683
949,관광지,천제연폭포,제주특별자치도 서귀포시 천제연로 132(중문동),1578,1520,1864,4962,1654
70,관광지,곽지해수욕장,제주특별자치도 제주시 애월읍 애월원당길 (곽지리),785,876,3265,4926,1642
487,관광지,성이시돌목장,제주특별자치도 제주시 한림읍 산록남로 53,1868,1062,1831,4761,1587
900,관광지,조은승마장,제주특별자치도 서귀포시 안덕면 동광로 265-14,1543,1313,1687,4543,1514
166,관광지,다랑쉬오름(월랑봉),제주특별자치도 제주시 구좌읍 세화리 2705,2118,1371,1030,4519,1506
1166,쇼핑,서귀포매일올레시장,서귀포시 중앙로 62번길 18,1557,1087,1845,4489,1496
327,관광지,백록담,제주특별자치도 서귀포시 토평동 산 15-1,1551,1452,1459,4462,1487
625,관광지,에코랜드 테마파크,제주특별자치도 제주시 조천읍 번영로 1278-169,1676,1347,1292,4315,1438
532,관광지,수월봉 지질트레일,제주특별자치도 제주시 한경면 노을해안로 1013-70,1849,923,1428,4200,1400
672,관광지,용두암,제주특별자치도 제주시 용두암길 15,1648,1157,1321,4126,1375
588,관광지,아쿠아플라넷 제주,제주특별자치도 서귀포시 성산읍 섭지코지로 95,1404,1280,1296,3980,1327
156,관광지,논짓물,제주특별자치도 서귀포시 하예동,668,327,2764,3759,1253
324,관광지,방주교회,제주특별자치도 서귀포시 안덕면 산록남로762번길 113,1668,958,1111,3737,1246
197,관광지,도두동 무지개 해안도로,제주특별자치도 제주시 도두1동,1407,631,1686,3724,1241
38,관광지,거문오름(UNESCO 세계자연유산),제주특별자치도 제주시 조천읍 선교로 569-36,1324,1107,1289,3720,1240
78,관광지,광치기해변,제주특별자치도 서귀포시 성산읍 섭지코지로 63,1617,757,1230,3604,1201
651,관광지,오설록티뮤지엄,제주특별자치도 서귀포시 안덕면 신화역사로 15,1415,1128,1061,3604,1201
666,관광지,외돌개,제주특별자치도 서귀포시 서홍동 791,1138,1272,1191,3601,1200
582,관광지,아부오름,제주특별자치도 제주시 구좌읍 송당리 산 164-1,1564,1100,932,3596,1199
1095,관광지,화순금모래해수욕장담수수영장,제주특별자치도 서귀포시 안덕면 화순리 776-8,148,280,3092,3520,1173
766,관광지,제주4.3평화공원,제주특별자치도 제주시 명림로 430,1370,1036,1065,3471,1157
608,관광지,애월해안도로,제주특별자치도 제주시 애월읍 애월해안로,1149,741,1478,3368,1123
795,관광지,제주레일바이크,제주특별자치도 제주시 구좌읍 용눈이오름로 641,1243,925,1163,3331,1110
531,관광지,수월봉,제주특별자치도 제주시 한경면 고산리 3760,1840,677,771,3288,1096
499,관광지,세화해변,제주특별자치도 제주시 구좌읍 해녀박물관길 27,1339,856,1029,3224,1075
328,관광지,백약이오름,제주특별자치도 서귀포시 표선면 성읍리 산 1,1060,1010,922,2992,997
397,관광지,산방굴사,제주특별자치도 서귀포시 안덕면 사계리 산 16,1032,897,1016,2945,982
431,관광지,새연교,제주특별자치도 서귀포시 서홍동 707-4,871,758,1215,2844,948
168,관광지,다이나믹메이즈,제주특별자치도 서귀포시 표선면 번영로 2644,642,838,1336,2816,939
198,관광지,도두봉,제주특별자치도 제주시 도두동 산 1,1315,686,789,2790,930
668,관광지,용눈이오름,제주특별자치도 제주시 구좌읍 종달논길,760,1048,942,2750,917
946,관광지,천아숲길 천아계곡,제주특별자치도 제주시 애월읍 봉성리 산 1,2177,322,231,2730,910
1109,관광지,휴애리 자연생활공원,"제주특별자치도 서귀포시 남원읍 신례동로 256 (신례리, 휴애리)",1101,856,770,2727,909
264,관광지,머체왓숲길,제주특별자치도 서귀포시 남원읍 서성로 755,607,504,1603,2714,905
1055,관광지,한림공원,제주특별자치도 제주시 한림읍 한림로 300,897,885,919,2701,900
317,관광지,박수기정,제주특별자치도 서귀포시 안덕면 난드르로 90-25,1399,600,686,2685,895
865,관광지,제주절물자연휴양림,제주특별자치도 제주시 명림로 584,915,835,926,2676,892
612,관광지,약천사,제주특별자치도 서귀포시 이어도로 293-28,696,941,985,2622,874
1022,관광지,표선해수욕장,제주특별자치도 서귀포시 표선면 표선리,572,393,1567,2532,844
1080,관광지,헬로키티아일랜드,제주특별자치도 서귀포시 안덕면 한창로 340,854,836,811,2501,834
232,관광지,따라비오름,제주특별자치도 서귀포시 표선면 가시리 산 62,1455,564,483,2502,834
508,관광지,소천지,제주특별자치도 서귀포시 칠십리로485번길 2,373,1003,1112,2488,829
1044,관광지,한담해변,제주특별자치도 제주시 애월읍 애월로1길 26-4,296,884,1268,2448,816
373,관광지,비양도,제주특별자치도 제주시 한림읍 협재리,593,495,1340,2428,809
452,관광지,서귀포치유의숲,제주특별자치도 서귀포시 산록남로 2271,919,717,782,2418,806
1098,관광지,환상숲 곶자왈공원,제주특별자치도 제주시 한경면 녹차분재로 594-1,838,705,834,2377,792
112,관광지,김경숙해바라기농장,제주특별자치도 제주시 번영로 854-1,473,636,1248,2357,786
646,관광지,오라동 청보리-메밀꽃밭,제주특별자치도 제주시 오라2동 산 76,985,764,582,2331,777
2,관광지,1100고지습지,제주특별자치도 서귀포시 색달동 산 1-2,805,709,814,2328,776
922,관광지,중문관광단지,제주특별자치도 서귀포시 중문관광로72번길 35,733,548,943,2224,741
266,관광지,메이즈랜드,제주특별자치도 제주시 구좌읍 비자림로 2134-47,791,717,706,2214,738
559,관광지,신창풍차해안도로,제주특별자치도 제주시 한경면 신창리 1322-1,833,607,765,2205,735
107,관광지,금악오름(왕매),제주특별자치도 제주시 한림읍 금악리 산 1-1,652,467,1059,2178,726
1209,쇼핑,제주관광공사 중문면세점 (내국인),제주특별자치도 서귀포시 중문관광로 224(중문동) 제주국제컨벤션센터 1F,707,562,906,2175,725
388,관광지,사계해변,제주특별자치도 서귀포시 안덕면 사계리 2147-35,863,367,946,2176,725
485,관광지,성읍민속마을,제주특별자치도 서귀포시 표선면 성읍정의현로 19,718,629,819,2166,722
446,관광지,서귀포예술의전당,제주특별자치도 서귀포시 태평로 270,1112,505,533,2150,717
3226,음식점,올래국수,제주특별자치도 제주시 귀아랑길 24 (연동),400,442,1289,2131,710
704,관광지,월령선인장군락지,제주특별자치도 제주시 한림읍 월령3길 27-4,847,615,669,2131,710
789,관광지,제주돌문화공원,제주특별자치도 제주시 조천읍 남조로 2023,744,719,646,2109,703
732,관광지,이호테우말등대,제주특별자치도 제주시 서해안로 58,640,577,887,2104,701
315,관광지,박물관은 살아있다,제주특별자치도 서귀포시 중문관광로 42,738,629,731,2098,699
621,관광지,엉또폭포,제주특별자치도 서귀포시 염돈로 121-8 (강정동),344,424,1303,2071,690
867,관광지,제주조천스위스마을,제주특별자치도 제주시 조천읍 함와로 566-27,687,639,717,2043,681
3403,음식점,제주김만복(만복이네김밥집),제주특별자치도 제주시 오라로 41,637,626,770,2033,678
862,관광지,제주유리의성,제주특별자치도 제주시 한경면 녹차분재로 462,566,658,799,2023,674
2691,음식점,몽상드애월(몽상),제주특별자치도 제주시 애월읍 애월북서길 56-1,1010,461,540,2011,670
419,관광지,삼양해수욕장,제주특별자치도 제주시 삼양동,397,340,1263,2000,667
439,관광지,서귀다원,제주특별자치도 서귀포시 상효동 산 118,864,378,751,1993,664
218,관광지,동백동산,제주특별자치도 제주시 조천읍 선흘리 산 12,776,592,623,1991,664
591,관광지,안덕계곡,제주특별자치도 서귀포시 안덕면 일주서로 1524,459,424,1106,1989,663
878,관광지,제주특별자치도 도립미술관,제주특별자치도 제주시 1100로 2894-78,607,655,722,1984,661
245,관광지,마라도(마라해양도립공원),제주특별자치도 서귀포시 대정읍 마라로101번길 46,659,663,660,1982,661
402,관광지,산방산탄산온천,제주특별자치도 서귀포시 안덕면 사계북로 41번길 192,740,576,668,1984,661
3279,음식점,우진해장국,제주특별자치도 제주시 서사로 11,381,684,897,1962,654
207,관광지,돈내코유원지,제주특별자치도 서귀포시 돈내코로 120,390,249,1321,1960,653
626,관광지,여미지식물원,제주특별자치도 서귀포시 중문관광로 93,656,536,747,1939,646
72,관광지,관덕정,제주특별자치도 제주시 관덕로 19,701,633,579,1913,638
584,관광지,아이스뮤지엄,제주특별자치도 제주시 은수길 69,419,473,1003,1895,632
1052,관광지,한라수목원,제주특별자치도 제주시 수목원길 72,772,522,590,1884,628
778,관광지,제주김녕미로공원,제주특별자치도 제주시 구좌읍 만장굴길 122,617,584,682,1883,628
856,관광지,제주올레 7코스,제주특별자치도 서귀포시 서홍동 795-1,735,549,595,1879,626
677,관광지,용연,제주특별자치도 제주시 흥운길 73,539,574,753,1866,622
85,관광지,"군산(군산오름,코메오름)",제주특별자치도 서귀포시 안덕면 창천리 564,792,539,533,1864,621
791,관광지,제주동백수목원,제주특별자치도 서귀포시 남원읍 위미중앙로300번길 15,930,511,398,1839,613
792,관광지,제주라프 짚라인,제주특별자치도 제주시 조천읍 선교로 117,659,484,657,1800,600
449,관광지,서귀포잠수함(대국해저관광),"제주특별자치도 서귀포시 남성중로 40 (서홍동, 유람선매표소) 서귀포잠수함",523,559,713,1795,598
698,관광지,원앙폭포,제주특별자치도 서귀포시 돈내코로 137,401,457,932,1790,597
298,관광지,물영아리오름,제주특별자치도 서귀포시 남원읍 남조로 988-11,675,454,662,1791,597
593,관광지,안돌오름,제주특별자치도 제주시 구좌읍 송당리 산 66-2,681,569,525,1775,592
686,관광지,우도산호해변 홍조단괴 서빈백사,제주특별자치도 제주시 우도면 우도해안길 252,574,440,753,1767,589
892,관광지,제주현대미술관,제주특별자치도 제주시 한경면 저지14길 35,529,537,676,1742,581
940,관광지,차귀도,제주특별자치도 제주시 한경면 고산리 125,682,435,592,1709,570
726,관광지,이중섭거리,제주특별자치도 서귀포시 이중섭로 4-1 (서귀동),560,440,706,1706,569
801,관광지,제주민속촌,제주특별자치도 서귀포시 표선면 민속해안로 631-34,573,571,562,1706,569
782,관광지,제주다원 녹차미로공원,제주특별자치도 서귀포시 산록남로 1258,694,451,558,1703,568
405,관광지,산지천,제주특별자치도 제주시 건입동,303,605,787,1695,565
352,관광지,본태박물관,제주특별자치도 서귀포시 안덕면 산록남로762번길 69,594,495,569,1658,553
713,관광지,윗세오름(웃세오름),제주특별자치도 제주시 애월읍 광령리 산 183-1,743,374,532,1649,550
803,관광지,제주베니스랜드,제주특별자치도 서귀포시 성산읍 난산리 2575,504,556,578,1638,546
884,관광지,제주항공우주박물관,제주특별자치도 서귀포시 안덕면 녹차분재로 218 항곡우주박물관,534,491,579,1604,535
538,관광지,스누피가든,제주특별자치도 제주시 구좌읍 금백조로 930,469,539,597,1605,535
433,관광지,생각하는정원,제주특별자치도 제주시 한경면 녹차분재로 675,567,481,552,1600,533
80,관광지,구엄리돌염전,제주특별자치도 제주시 애월읍 애월해안로 708,618,468,497,1583,528
252,관광지,마방목지,제주특별자치도 제주시 516로 2480,485,444,647,1576,525
289,관광지,문도지오름 (문돗지),제주특별자치도 제주시 한림읍 금악리 3444,261,641,665,1567,522
463,관광지,선녀와나무꾼,제주특별자치도 제주시 조천읍 선교로 267,531,476,556,1563,521
2693,음식점,몽키비치클럽 Monkey Beach,서귀포시 중문관광로72번길 29-9,346,468,744,1558,519
1094,관광지,화순금모래해수욕장,제주특별자치도 서귀포시 안덕면 화순해안로 91,526,232,775,1533,511
982,관광지,케이제주씨워킹,제주특별자치도 서귀포시 대정읍 최남단해안로 120,303,372,859,1534,511
147,관광지,너븐숭이 4.3기념관,제주특별자치도 제주시 조천읍 북촌3길 3,599,488,434,1521,507
481,관광지,성산항,제주특별자치도 서귀포시 성산읍 성산등용로 129-21,764,306,450,1520,507
812,관광지,제주빅볼랜드,제주특별자치도 제주시 애월읍 산록서로 15,545,410,554,1509,503
1,관광지,1100고지(휴게소),제주특별자치도 서귀포시 1100로 1555,641,400,457,1498,499
238,관광지,레이저서바이벌M,제주특별자치도 제주시 신광로 58 4층,469,465,561,1495,498
1334,숙박,나미송 머무는 곳,제주특별자치도 제주시 애월읍 평화로 2476,458,555,478,1491,497
7,관광지,9.81 파크,제주특별자치도 제주시 애월읍 천덕로 880-24,515,389,580,1484,495
570,관광지,싱계물 공원,제주 제주시 한경면 신창리 1322-1,430,391,661,1482,494
706,관광지,월정리 카약체험장,제주특별자치도 제주시 구좌읍 일주동로 2361-2,380,380,723,1483,494
1387,숙박,대명리조트 제주,제주특별자치도 제주시 조천읍 신북로 577,551,439,489,1479,493
443,관광지,서귀포 하영올레,제주특별자치도 서귀포시 중앙로 105,654,440,372,1466,489
143,관광지,남원큰엉해변,제주특별자치도 서귀포시 남원읍 태위로 522-17,421,377,670,1468,489
735,관광지,일출랜드,제주특별자치도 서귀포시 성산읍 중산간동로 4150-30,522,428,511,1461,487
796,관광지,제주레포츠랜드,제주특별자치도 제주시 조천읍 와흘상서2길 47,428,485,547,1460,487
412,관광지,삼다수숲길 지질트레일,제주특별자치도 제주시 조천읍 교래3길 98,696,351,406,1453,484
206,관광지,돈내코,제주특별자치도 서귀포시 516로 (상효동),317,343,768,1428,476
723,관광지,이상한 나라의 앨리스,제주특별자치도 서귀포시 안덕면 중산간서로 1881,454,418,541,1413,471
2820,음식점,봄날카페,제주특별자치도 제주시 애월읍 애월로1길 25,442,639,317,1398,466
1012,관광지,퍼시픽 리솜 요트투어 샹그릴라,제주특별자치도 서귀포시 중문관광로 154-17,381,404,605,1390,463
361,관광지,북촌돌하르방미술관,제주특별자치도 제주시 조천읍 북촌서1길 70,401,314,666,1381,460
506,관광지,소인국테마파크,제주특별자치도 서귀포시 안덕면 중산간서로 1878,518,402,435,1355,452
891,관광지,제주허브동산,제주특별자치도 서귀포시 표선면 돈오름로 170,536,431,384,1351,450
272,관광지,모슬포항,제주특별자치도 서귀포시 대정읍 신영로36번길 48,521,366,456,1343,448
815,관광지,제주세계자연유산센터,제주특별자치도 제주시 조천읍 선교로 569-36(선흘리 478),463,430,436,1329,443
401,관광지,산방산 용머리해안 지질트레일,제주특별자치도 서귀포시 안덕면 사계북로41번길 192,633,321,370,1324,441
1093,관광지,화순곶자왈생태탐방숲길,제주특별자치도 서귀포시 안덕면 화순서동로 151,489,409,418,1316,439
769,관광지,제주곶자왈도립공원,제주특별자치도 서귀포시 대정읍 에듀시티로 178,472,444,398,1314,438
2123,숙박,한화리조트 제주,"제주특별자치도 제주시 명림로 575-107 (회천동, 한화리조트) 한화리조트 제주",562,377,358,1297,432
1049,관광지,한라산어리목코스,제주특별자치도 제주시 1100로 2070-61,640,329,324,1293,431
811,관광지,제주불빛정원 테마파크,제주특별자치도 제주시 애월읍 평화로 2346,414,356,502,1272,424
962,관광지,초콜릿박물관,제주특별자치도 서귀포시 대정읍 일주서로3000번길 144,367,372,531,1270,423
552,관광지,신양섭지해수욕장,제주특별자치도 서귀포시 성산읍 섭지코지로 107,248,236,781,1265,422
595,관광지,알뜨르비행장,제주특별자치도 서귀포시 대정읍 상모리 1670,420,432,409,1261,420
547,관광지,신비의도로,제주특별자치도 제주시 1100로 2894-63,437,327,486,1250,417
745,관광지,저지 예술인 마을,제주특별자치도 제주시 한경면 저지14길 28-4,418,306,523,1247,416
1173,쇼핑,세화해녀민속오일시장,제주특별자치도 제주시 구좌읍 해맞이해안로 1412,733,303,210,1246,415
847,관광지,제주올레 1코스,제주특별자치도 서귀포시 성산읍 오조리 396-1,487,404,353,1244,415
194,관광지,더마파크,제주특별자치도 제주시 한림읍 월림7길 155,421,408,413,1242,414
834,관광지,제주올레 10코스,제주특별자치도 서귀포시 대정읍 상모리 산 2-27,461,409,373,1243,414
1084,관광지,협재굴(한림공원),제주특별자치도 제주시 한림읍 한림로 300,380,370,489,1239,413
575,관광지,아날로그감귤밭,제주특별자치도 제주시 해안마을8길 46,520,385,334,1239,413
392,관광지,사라오름,제주특별자치도 서귀포시 남원읍 신례리 산 2-1,496,275,462,1233,411
125,관광지,김영갑갤러리 두모악,제주특별자치도 서귀포시 성산읍 삼달로 137,415,289,525,1229,410
73,관광지,관음사,제주특별자치도 제주시 산록북로 660,358,250,611,1219,406
516,관광지,송당승마장,제주특별자치도 제주시 구좌읍 번영로 2015,375,340,500,1215,405
580,관광지,아르떼뮤지엄,제주특별자치도 제주시 애월읍 어림비로 478,421,358,431,1210,403
1068,관광지,해녀박물관,제주특별자치도 제주시 구좌읍 해녀박물관길 26,395,380,430,1205,402
192,관광지,"더럭초등학교(구, 더럭분교)",제주특별자치도 제주시 애월읍 하가로 195,361,399,436,1196,399
116,관광지,김녕사굴,제주특별자치도 제주시 구좌읍 덕천리 201-4,345,356,496,1197,399
453,관광지,서귀포칠십리시공원,제주특별자치도 서귀포시 서홍동 576-9,460,361,373,1194,398
120,관광지,김녕해수욕장야영장,제주특별자치도 제주시 구좌읍 해맞이해안로 7-6,289,265,639,1193,398
25,관광지,감귤박물관,제주특별자치도 서귀포시 효돈순환로 441,512,300,381,1193,398
673,관광지,용두암해안도로카페거리,제주특별자치도 제주시 용담3동,483,323,383,1189,396
1308,숙박,금호리조트제주,제주특별자치도 서귀포시 남원읍 태위로 522-12,464,308,401,1173,391
719,관광지,이니스프리제주하우스,제주특별자치도 서귀포시 안덕면 신화역사로 23,354,359,460,1173,391
1236,쇼핑,한림민속오일시장,제주특별자치도 제주시 한림읍 한수풀로4길 10,423,299,439,1161,387
1057,관광지,한림항,제주특별자치도 제주시 한림읍 한림해안로 192,391,338,415,1144,381
586,관광지,아침미소목장,제주특별자치도 제주시 첨단동길 160-20,391,361,391,1143,381
874,관광지,제주카트클럽,제주특별자치도 제주시 한림읍 중산간서로 3853,376,309,453,1138,379
3022,음식점,순옥이네 명가,제주 제주시 도공로 8,281,416,436,1133,378
986,관광지,큰노꼬메오름,제주특별자치도 제주시 애월읍 유수암리 산 138,565,305,262,1132,377
150,관광지,노리매공원,제주특별자치도 서귀포시 대정읍 중산간서로 2260-15,432,332,368,1132,377
689,관광지,우도잠수함(제주씨월드),제주특별자치도 서귀포시 성산읍 성산등용로 130-21,361,317,452,1130,377
2140,숙박,해비치호텔앤드리조트,제주특별자치도 서귀포시 표선면 민속해안로 537,356,373,401,1130,377
390,관광지,사라봉,제주특별자치도 제주시 사라봉동길 61,451,324,353,1128,376
574,관광지,아끈다랑쉬,제주특별자치도 제주시 구좌읍 세화리 2593,492,393,242,1127,376
333,관광지,범섬,제주특별자치도 서귀포시 법환동,394,337,394,1125,375
564,관광지,신화테마파크,서귀포시 안덕면 신화역사로304번길 98,378,341,405,1124,375
716,관광지,유민미술관,제주특별자치도 서귀포시 성산읍 고성리 21,384,363,376,1123,374
2936,음식점,서연의집(영화 건축학개론),제주특별자치도 서귀포시 남원읍 위미해안로 86,320,447,354,1121,374
821,관광지,제주실탄사격장,제주특별자치도 서귀포시 소보리당로 164번길 62(상예동),360,312,450,1122,374
337,관광지,법환포구,제주특별자치도 서귀포시 막숙포로37번길 2,342,381,393,1116,372
459,관광지,서우봉,제주특별자치도 제주시 조천읍 함덕리 169-1,390,431,294,1115,372
886,관광지,제주해양동물박물관,제주특별자치도 서귀포시 성산읍 서성일로 689-21,347,344,422,1113,371
1066,관광지,항파두리항몽유적지,제주특별자치도 제주시 애월읍 항파두리로 50,464,325,323,1112,371
488,관광지,성클라라수도원 금악성당,제주시 한림읍 금악북로 320,200,182,724,1106,369
17,관광지,가뫼물,제주특별자치도 서귀포시 남원읍 남위남성로 168,365,340,387,1092,364
880,관광지,제주평화박물관(전쟁평화박물관)[휴관중],제주시 한경면 청수서5길 63,283,309,494,1086,362
853,관광지,제주올레 5코스,제주특별자치도 서귀포시 남원읍 남태해안로 140,424,340,323,1087,362
611,관광지,액티브파크,제주특별자치도 제주시 한림읍 금능남로 76,348,309,429,1086,362
403,관광지,산양곶자왈,제주특별자치도제주시 한경면 청수리 956-6,331,194,557,1082,361
993,관광지,탑동해변공연장,제주특별자치도 제주시 중앙로 2,286,260,535,1081,360
1035,관광지,하도해변,제주특별자치도 제주시 구좌읍 해맞이해안로,287,177,615,1079,360
616,관광지,어승생,제주특별자치도 제주시 해안동 1100도로 555번지 (해안동 산220-12번지),480,323,273,1076,359
303,관광지,민속자연사박물관,제주특별자치도 제주시 삼성로 40,366,384,325,1075,358
49,관광지,검멀레해변,제주특별자치도 제주시 우도면 우도해안길,401,300,370,1071,357
882,관광지,제주하늘을날다(패러글라이딩),제주특별자치도 제주시 도남로17길 32 영산홍아파트 가동,290,310,472,1072,357
793,관광지,제주러브랜드[휴업중],제주특별자치도 제주시 1100로 2894-72,358,357,354,1069,356
525,관광지,쇠소깍해변,제주특별자치도 서귀포시 하효동,316,309,440,1065,355
113,관광지,김녕 지질트레일,제주특별자치도 제주시 구좌읍 김녕로 209,351,370,341,1062,354
426,관광지,상효원,제주특별자치도 서귀포시 산록남로 2847-37,483,315,250,1048,349
75,관광지,관음사 야영장,제주특별자치도 제주시 산록북로 588,238,258,550,1046,349
2214,음식점,濟州膳제주선,제주특별자치도 서귀포시 안덕면 신화역사로304번길 38,296,384,363,1043,348
2664,음식점,명진전복,제주특별자치도 제주시 구좌읍 해맞이해안로 1282,337,383,323,1043,348
658,관광지,올레여행자센터,제주특별자치도 서귀포시 중정로 22,449,278,313,1040,347
464,관광지,선운정사,제주특별자치도 제주시 애월읍 구몰동길 65,361,334,335,1030,343
681,관광지,우도 비양도,제주특별자치도 제주시 우도면 연평리,436,251,340,1027,342
1090,관광지,혼인지,제주특별자치도 서귀포시 성산읍 혼인지로 39-22,335,342,344,1021,340
1009,관광지,파파빌레,제주특별자치도 제주시 조천읍 남조로 2185,385,278,354,1017,339
948,관광지,천왕사,제주특별자치도 제주시 1100로 2528-111,374,331,306,1011,337
1106,관광지,훈데르트바서파크,제주특별자치도 제주시 우도면 우도해안길 32-12,271,280,453,1004,335
84,관광지,국립제주박물관,제주특별자치도 제주시 일주동로 17,376,299,326,1001,334
652,관광지,오조포구,제주특별자치도 서귀포시 성산읍 오조리,190,379,432,1001,334
528,관광지,수목원테마파크,제주특별자치도 제주시 은수길 69 (연동),376,289,335,1000,333
148,관광지,넥슨컴퓨터박물관,제주특별자치도 제주시 1100로 3198-8,362,297,340,999,333
563,관광지,신화워터파크,제주특별자치도 서귀포시 안덕면 신화역사로304번길 38,184,290,524,998,333
740,관광지,자구리공원,제주특별자치도 서귀포시 칠십리로 145,392,293,312,997,332
524,관광지,쇠소깍제트,제주특별자치도 서귀포시 쇠소깍로 151-8 (하효동),264,241,491,996,332
1037,관광지,하멜상선전시관,제주특별자치도 서귀포시 안덕면 사계남로216번길 24-30,305,288,395,988,329
818,관광지,제주승마공원,제주특별자치도 제주시 애월읍 녹고메길 152-1,267,250,457,974,325
942,관광지,차귀도유람선,제주특별자치도 제주시 한경면 노을해안로 1163 차귀도유람선,529,224,219,972,324
978,관광지,캐니언파크,제주특별자치도 제주시 삼무로 51,201,278,483,962,321
379,관광지,비체올린,제주시 한경면 판조로 253-6,269,281,414,964,321
2478,음식점,돈사돈,제주특별자치도 제주시 우평로 19,218,296,445,959,320
969,관광지,추자도,제주특별자치도 제주시 추자면 추자도,326,336,296,958,319
1167,쇼핑,서귀포향토오일시장,제주특별자치도 서귀포시 중산간동로7894번길 18-5,375,248,335,958,319
1133,쇼핑,동문수산시장,제주특별자치도 제주시 관덕로 64-1,321,312,322,955,318
914,관광지,종달리수국길,제주특별자치도 제주시 구좌읍 해맞이해안로 2121,250,272,432,954,318
557,관광지,신창~차귀해안도로,제주특별자치도 제주시 한경면 한경해안로 470,318,284,344,946,315
787,관광지,제주도립김창열미술관,제주특별자치도 제주시 한경면 용금로 883-5,340,324,282,946,315
79,관광지,교래자연휴양림,제주특별자치도 제주시 조천읍 남조로 2023,425,225,288,938,313
491,관광지,세계자동차 & 피아노박물관,제주특별자치도 서귀포시 안덕면 중산간서로 1610,321,264,353,938,313
219,관광지,동백포레스트,서귀포시 남원읍 신례리 1767,522,231,168,921,307
1883,숙박,제주가좋아서 펜션,제주특별자치도 제주시 구좌읍 비자림로 1569,242,336,341,919,306
429,관광지,새섬,제주특별자치도 서귀포시 남성중로 40,282,347,288,917,306
827,관광지,제주어울림감귤체험농장,제주특별자치도 서귀포시 성산읍 서성일로 809,347,263,289,899,300
57,관광지,고살리숲길,제주특별자치도 서귀포시 남원읍 하례리 산 54-2,377,165,355,897,299
870,관광지,제주참숯가마찜질방,제주특별자치도 서귀포시 성산읍 삼달로 47,362,311,208,881,294
435,관광지,샤이니숲길,제주특별자치도 제주시 조천읍 교래리 719-10,312,244,324,880,293
724,관광지,이승이오름(이승악),제주특별자치도 서귀포시 남원읍 신례리 산 12-19,405,223,251,879,293
728,관광지,이중섭미술관,제주특별자치도 서귀포시 이중섭로 27-3,338,254,281,873,291
382,관광지,빛의 벙커,제주특별자치도 서귀포시 성산읍 서성일로1168번길 89-17,429,432,12,873,291
216,관광지,동굴의 다원 다희연,제주특별자치도 제주시 조천읍 선교로 266,342,214,298,854,285
416,관광지,삼성혈,제주특별자치도 제주시 삼성로 22,322,250,282,854,285
894,관광지,제주힐링명상센터,제주특별자치도 제주시 애월읍 어음13길 196,258,300,295,853,284
384,관광지,뽀로로&타요 테마파크 제주,제주특별자치도 서귀포시 안덕면 병악로 269,243,247,361,851,284
91,관광지,귤밭76번지,제주특별자치도 서귀포시 안덕면 병악로 76,374,260,214,848,283
434,관광지,생이기정,제주특별자치도 제주시 한경면 용수리 산 60,284,246,320,850,283
688,관광지,우도올레보트,제주특별자치도 제주시 우도면 연평리 2562-1,279,223,347,849,283
924,관광지,중문미로파크,제주특별자치도 서귀포시 일주서로 1225-5,343,233,269,845,282
977,관광지,카카오본사(구 스페이스닷원),제주특별자치도 제주시 첨단로 242,350,239,258,847,282
997,관광지,테디베어뮤지엄제주,제주특별자치도 서귀포시 중문관광로110번길 31,295,247,302,844,281
344,관광지,별방진,제주특별자치도 제주시 구좌읍 하도리 3354,289,213,342,844,281
1218,쇼핑,중문향토오일시장,제주특별자치도 서귀포시 천제연로188번길 12,384,210,246,840,280
241,관광지,렛츠런팜제주,제주특별자치도 제주시 조천읍 남조로 1660,280,245,314,839,280
1223,쇼핑,카카오프렌즈 스토어@제주,제주특별자치도 제주시 첨단로 242,174,199,461,834,278
576,관광지,아라고나이트 온천(디아넥스호텔),제주특별자치도 서귀포시 안덕면 산록남로762번길 71,298,258,277,833,278
1099,관광지,환상숲곶자왈 담앙족욕,제주특별자치도 제주시 한경면 녹차분재로 594-1,307,230,295,832,277
1943,숙박,제주조천스위스마을게스트하우스,제주특별자치도 제주시 조천읍 함와로 566-27,276,271,279,826,275
857,관광지,제주올레 8코스,제주특별자치도 서귀포시 예래해안로 256,305,260,260,825,275
94,관광지,그랑블루 요트투어,제주특별자치도 서귀포시 대포로 174,277,228,314,819,273
710,관광지,위미리 동백나무군락,제주특별자치도 서귀포시 남원읍 위미중앙로300번길 23-7,410,213,191,814,271
1239,쇼핑,함덕민속오일시장,제주특별자치도 제주시 조천읍 함덕16길 15-13,210,205,392,807,269
1087,관광지,형제섬,제주특별자치도 서귀포시 안덕면 사계리 산 44,201,206,397,804,268
371,관광지,브릭캠퍼스,제주특별자치도 제주시 1100로 3047,255,241,309,805,268
3678,음식점,테라로사,제주특별자치도 서귀포시 칠십리로658번길 27-16,363,234,205,802,267
461,관광지,서프라이즈테마파크,제주특별자치도 제주시 조천읍 남조로 2243,247,251,301,799,266
1051,관광지,한라생태숲,제주특별자치도 제주시 516로 2596,314,242,241,797,266
117,관광지,김녕요트투어,제주특별자치도 제주시 구좌읍 구좌해안로 229-16,214,247,337,798,266
519,관광지,송악산 진지동굴,제주특별자치도 서귀포시 대정읍 상모리,311,208,277,796,265
548,관광지,신비의도로카트체험장,제주특별자치도 제주시 노형동 187-3,148,256,391,795,265
399,관광지,산방산 랜드,제주특별자치도 서귀포시 안덕면 사계남로216번길 24-32,257,267,267,791,264
734,관광지,익스트림제주 카약올레,제주시 애월읍 애월로1길 22,235,228,329,792,264
799,관광지,제주문예회관,제주특별자치도 제주시 동광로 69,206,286,294,786,262
2332,음식점,김희선몸국,제주특별자치도 제주시 어영길 45-6,207,228,344,779,260
875,관광지,제주커피박물관 바움 Baum,제주특별자치도 서귀포시 성산읍 서성일로1168번길 89-17,253,240,288,781,260
454,관광지,서귀포항,제주특별자치도 서귀포시 칠십리로72번길 14,268,267,244,779,260
604,관광지,애월 한담 카약,제주 제주시 애월읍 애월로1길 25,198,222,360,780,260
935,관광지,지미봉,제주특별자치도 제주시 구좌읍 종달로1길 91-16,279,232,262,773,258
2579,음식점,리치망고,제주특별자치도 제주시 애월읍 애월해안로 272,211,311,248,770,257
367,관광지,붉은오름 자연휴양림,제주특별자치도 서귀포시 표선면 남조로 1487-73,290,227,250,767,256
1219,쇼핑,지소울,제주특별자치도 제주시 진남로10길 7,327,376,64,767,256
816,관광지,제주센트럴파크,제주특별자치도 제주시 조천읍 비자림로 606,284,246,237,767,256
68,관광지,곶자왈,제주특별자치도 서귀포시 대정읍 신평리,289,235,245,769,256
160,관광지,누웨마루거리(구 바오젠),제주특별자치도 제주시 신광로 47,264,227,277,768,256
3730,음식점,핀크스 비오토피아,서귀포시 안덕면 산록남로762번길 79,268,245,253,766,255
992,관광지,탑동,제주특별자치도 제주시 중앙로 2,239,239,288,766,255
1026,관광지,플레이네이쳐,서귀포시 안덕면 일주서로 1836,308,218,233,759,253
670,관광지,용담/용두암 해안도로,제주특별자치도 제주시 서해안로 687-8,274,233,252,759,253
1172,쇼핑,성산-고성오일시장,제주특별자치도 서귀포시 성산읍 고성오조로 93,220,193,345,758,253
6,관광지,5.16도로숲터널,제주특별자치도 서귀포시 남원읍 신례리 산 2-1,264,195,299,758,253
991,관광지,탐나라공화국(제주남이섬),제주특별자치도 제주시 한림읍 한창로 897,312,215,220,747,249
917,관광지,종달리해안도로,제주특별자치도 제주시 구좌읍 종달리 630-1,268,217,259,744,248
2186,숙박,휘닉스 제주 섭지코지,제주특별자치도 서귀포시 성산읍 섭지코지로 107,220,279,241,740,247
589,관광지,아프리카박물관,제주특별자치도 서귀포시 이어도로 49,223,230,287,740,247
482,관광지,성읍녹차마을,제주특별자치도 서귀포시 표선면 중산간동로 4778,416,162,161,739,246
448,관광지,서귀포자연휴양림,제주특별자치도 서귀포시 1100로 882,353,166,220,739,246
155,관광지,녹산로유채꽃길,제주특별자치도 서귀포시 표선면 가시리 산 87-15,264,251,219,734,245
768,관광지,제주공룡랜드[휴장중],제주특별자치도 제주시 애월읍 광령평화2길 1,226,248,261,735,245
822,관광지,제주아리랑 NEW 혼,제주특별자치도 서귀포시 표선면 번영로 2564-21,315,206,207,728,243
436,관광지,서건도,제주특별자치도 서귀포시 강정동 산 1,231,250,244,725,242
507,관광지,소정방폭포,제주특별자치도 서귀포시 칠십리로214번길 17-17,300,179,246,725,242
871,관광지,제주추사관,제주특별자치도 서귀포시 대정읍 추사로 44,284,223,215,722,241
536,관광지,쉬리의언덕,제주특별자치도 서귀포시 중문관광로72번길 114,303,187,232,722,241
845,관광지,제주올레 18코스,제주특별자치도 제주시 삼양1동 1131-2,255,242,224,721,240
854,관광지,제주올레 6코스,제주특별자치도 서귀포시 보목동 1377-4,335,192,191,718,239
896,관광지,조랑말체험공원,제주특별자치도 서귀포시 표선면 녹산로 381-15,248,211,257,716,239
998,관광지,테디베어사파리 테지움,제주특별자치도 제주시 애월읍 평화로 2159,224,216,275,715,238
43,관광지,건강과성박물관,제주특별자치도 서귀포시 안덕면 일주서로 1611,241,212,253,706,235
1000,관광지,토끼섬,제주특별자치도 제주시 구좌읍 하도리,222,198,285,705,235
2220,음식점,가시아방,제주특별자치도 서귀포시 성산읍 섭지코지로 10,203,282,219,704,235
620,관광지,엉덩물계곡,제주특별자치도 서귀포시 중문관광로 192,241,165,300,706,235
3350,음식점,일출봉쑥빵보리빵,제주특별자치도 서귀포시 성산읍 성산중앙로 30-3,475,110,118,703,234
314,관광지,바이나흐튼 크리스마스 박물관,제주특별자치도 서귀포시 안덕면 평화로 654,303,192,208,703,234
188,관광지,대평포구,제주특별자치도 서귀포시 안덕면 감천로190번길 9-62-2,214,224,265,703,234
771,관광지,제주국제공항,제주특별자치도 제주시 공항로 2,240,240,218,698,233
743,관광지,장생의 숲길,제주특별자치도 제주시 명림로 584,292,176,230,698,233
2460,음식점,델문도,제주특별자치도 제주시 조천읍 조함해안로 519-10,210,271,216,697,232
852,관광지,제주올레 4코스,제주특별자치도 서귀포시 남원읍 태흥리 200-2,250,165,277,692,231
712,관광지,윈드1947 카트 테마파크,제주특별자치도 서귀포시 토평공단로 78-27,280,191,218,689,230
99,관광지,금능석물원,제주특별자치도 제주시 한림읍 한림로 176,307,189,193,689,230
961,관광지,초콜릿랜드,제주특별자치도 서귀포시 중문관광로110번길 15,224,225,240,689,230
2585,음식점,마노르블랑,서귀포시 안덕면 일주서로2100번길 46,218,244,224,686,229
1028,관광지,피규어뮤지엄 제주,제주특별자치도 서귀포시 안덕면 한창로 243,203,211,273,687,229
984,관광지,코코몽 에코파크,제주특별자치도 서귀포시 남원읍 태위로 536,210,197,276,683,228
114,관광지,김녕 청굴물,제주특별자치도 제주시 구좌읍 김녕리 1296,271,194,214,679,226
1705,숙박,신라호텔제주,제주도 서귀포시 중문관광로 72번길 75,196,237,239,672,224
861,관광지,제주유리박물관,제주특별자치도 서귀포시 중산간서로 1403,204,214,252,670,223
471,관광지,섯알오름,제주특별자치도 서귀포시 대정읍 상모리 1618,208,230,230,668,223
750,관광지,점보빌리지,제주특별자치도 서귀포시 안덕면 평화로 319번길 31-11,212,218,239,669,223
599,관광지,알작지해변,제주특별자치도 제주시 테우해안로 60,222,206,240,668,223
825,관광지,제주안전체험관,제주특별자치도 제주시 애월읍 평화로 1885,194,229,243,666,222
843,관광지,제주올레 17코스,제주특별자치도 제주시 도두1동 2612-1,255,221,189,665,222
1027,관광지,플레이박스VR,제주특별자치도 제주시 은수길 69,198,210,258,666,222
381,관광지,빌레못동굴,제주특별자치도 제주시 애월읍 어음리 1391,239,213,209,661,220
1155,쇼핑,벨롱장,제주특별자치도 제주시 구좌읍 세화1길 20-8,228,203,230,661,220
1064,관광지,함덕카페거리,제주특별자치도 제주시 조천읍 함덕리,209,199,252,660,220
567,관광지,신흥2리 동백마을,제주특별자치도 서귀포시 남원읍 한신로531번길 22-1,252,193,216,661,220
1048,관광지,한라산소주공장,제주특별자치도 제주시 한림읍 한림로 555,179,170,309,658,219
96,관광지,그리스신화박물관 / 트릭아이미술관,제주특별자치도 제주시 한림읍 광산로 942,188,216,254,658,219
307,관광지,민오름(오라동),제주특별자치도 제주시 오라2동 산 12,257,181,216,654,218
302,관광지,미천굴,제주특별자치도 서귀포시 성산읍 온평동로34번길 18,217,205,228,650,217
534,관광지,순례자의교회,제주특별자치도 제주시 한경면 일주서로 3960-24,222,186,237,645,215
535,관광지,숫모르편백나무숲길,제주특별자치도 제주시 516로 2596,270,175,199,644,215
33,관광지,강정천유원지,제주특별자치도 서귀포시 강정통물로 (강정동),140,145,360,645,215
1062,관광지,함덕야영장,제주특별자치도 제주시 조천읍 함덕리 1008,159,184,303,646,215
3046,음식점,스카이 온 파이브 다이닝,제주특별자치도 서귀포시 안덕면 신화역사로304번길 38 메리어트관 제주신화월드 호텔앤리조트 5층,202,237,203,642,214
1042,관광지,한국야구명예전당(야구박물관),제주특별자치도 서귀포시 중산간서로 97-1,201,175,262,638,213
2224,음식점,가파도해물짜장짬뽕,제주특별자치도 서귀포시 대정읍 가파로67번길 1,186,380,74,640,213
802,관광지,제주바다체험장,제주특별자치도 제주시 구좌읍 동복리 608-3,170,171,294,635,212
1097,관광지,화조원,제주특별자치도 제주시 애월읍 애원로 804,216,228,190,634,211
684,관광지,우도봉 ATV,제주특별자치도 제주시 우도면 우도봉길 47,240,172,221,633,211
887,관광지,제주해양레저,제주특별자치도 서귀포시 중문관광로 192,132,153,346,631,210
2574,음식점,르 쉬느아 (Le Chinois),제주특별자치도 서귀포시 안덕면 신화역사로304번길 38 메리어트관 제주신화월드 호텔앤리조트 G층,165,262,202,629,210
203,관광지,도순다원,제주특별자치도 서귀포시 중산간서로356번길 152-41,240,188,200,628,209
1891,숙박,제주도푸른바다,제주도 제주시 구좌읍 별방길 109,168,200,259,627,209
888,관광지,제주해양레저파크,제주특별자치도 서귀포시 예래해안로 97,117,166,343,626,209
153,관광지,노을해안로,제주특별자치도 서귀포시 대정읍 노을해안로 24,256,152,220,628,209
527,관광지,수목원테마공원(야시장길&LED공원),제주특별자치도 제주시 은수길 69,212,193,223,628,209
3271,음식점,우무(umu),제주특별자치도 제주시 한림읍 한림로 542-1,232,187,209,628,209
774,관광지,제주국제컨벤션센터 icc,제주특별자치도 서귀포시 중문관광로 224,210,167,248,625,208
958,관광지,청수곶자왈,제주특별자치도 제주시 한경면 대한로 1036,191,194,238,623,208
93,관광지,"그대, 나의 뮤즈 : 클림트 to 마티스",제주특별자치도 서귀포시 안덕면 신화역사로304번길 38 제주신화월드 서머셋클럽하우스,197,182,242,621,207
12,관광지,WE호텔 웰니스센터,제주특별자치도 서귀포시 1100로 453-95,203,196,221,620,207
1056,관광지,한림바다체험마을,제주특별자치도 제주시 한림읍 한림해안로 200,192,178,247,617,206
299,관광지,물찻오름,제주특별자치도 제주시 조천읍 교래길,200,223,196,619,206
3396,음식점,제주901,제주특별자치도 제주시 1100로 2977-10,200,225,194,619,206
1103,관광지,황우지해안 열두굴,제주특별자치도 서귀포시 서홍동 764-1,162,229,222,613,204
394,관광지,사려니오름,제주특별자치도 서귀포시 남원읍 516로 1648-87,321,142,150,613,204
751,관광지,정모시쉼터,제주특별자치도 서귀포시 부두로5번길 9,115,93,400,608,203
480,관광지,성산포항,서귀포시 성산읍 성산등용로 130-21,222,193,195,610,203
48,관광지,검멀레동굴,제주특별자치도 제주시 우도면,219,169,214,602,201
665,관광지,왕이메오름,제주특별자치도 서귀포시 안덕면 광평리 산 79,287,158,156,601,200
389,관광지,사계해안도로,제주특별자치도 서귀포시 안덕면 사계리,214,176,210,600,200
1296,숙박,그랜드 하얏트 제주,제주특별자치도 제주시 노연로 12,204,198,195,597,199
1031,관광지,하고수동해변,제주특별자치도 제주시 우도면 연평리,154,156,285,595,198
2264,음식점,고집돌우럭(제주공항점),제주특별자치도 제주시 임항로 30,177,189,229,595,198
906,관광지,조천함덕해안도로,제주특별자치도 제주시 조천읍 조천8길 14-1,237,166,189,592,197
2046,숙박,파르나스 호텔 제주,제주특별자치도 서귀포시 중문관광로72번길 100 (색달동),103,145,342,590,197
1108,관광지,휴림,제주특별자치도 제주시 애월읍 광령남서길 40,211,189,191,591,197
746,관광지,"저지오름(닥몰오름,새오름)",제주특별자치도 제주시 한경면 저지리 산 51,208,160,223,591,197
450,관광지,서귀포천문과학문화관,제주특별자치도 서귀포시 1100로 506-1,181,159,246,586,195
671,관광지,용담레포츠공원,제주특별자치도 제주시 서해안로 580,186,214,185,585,195
183,관광지,대장금촬영지(제주민속촌),제주특별자치도 서귀포시 표선면 민속해안로 631-34,206,139,239,584,195
1144,쇼핑,모슬포중앙시장,제주특별자치도 서귀포시 대정읍 영서중로 3,263,161,155,579,193
3280,음식점,운정이네,제주특별자치도 서귀포시 안덕면 일주서로 1524,158,238,184,580,193
939,관광지,질그랭이센터,제주특별자치도 제주시 구좌읍 세평항로 46-9,192,173,214,579,193
340,관광지,별내린전망대,제주특별자치도 서귀포시 색달동 2938-1,211,185,184,580,193
936,관광지,지포뮤지엄,제주특별자치도 서귀포시 성산읍 섭지코지로 107,178,189,212,579,193
276,관광지,목장카페 드르쿰다,제주특별자치도 서귀포시 표선면 번영로 2454,200,187,189,576,192
683,관광지,우도등대,제주특별자치도 제주시 우도면 우도봉길 105,215,187,174,576,192
154,관광지,노형수퍼마?,제주특별자치도 제주시 노형로 89,573,0,0,573,191
173,관광지,"당산봉(당오름,차귀오름)",제주특별자치도 제주시 한경면 고산리 산 15,202,188,182,572,191
1014,관광지,평대리해변,제주특별자치도 제주시 구좌읍 평대리 515-24,171,182,219,572,191
282,관광지,무민랜드,제주특별자치도 서귀포시 안덕면 병악로 420,190,184,195,569,190
483,관광지,성읍랜드,제주특별자치도 서귀포시 표선면 번영로 2650,165,173,233,571,190
1216,쇼핑,제주칠성로상가,제주특별자치도 제주시 관덕로13길 12,203,207,161,571,190
623,관광지,엉알해안산책로,제주특별자치도 제주시 한경면 노을해안로 1143,225,174,167,566,189
850,관광지,제주올레 2코스,제주특별자치도 서귀포시 성산읍 고성리 2563-3,264,175,129,568,189
204,관광지,도치돌 알파카목장,제주특별자치도 제주시 애월읍 도치돌길 293,185,207,172,564,188
1002,관광지,토이파크,제주특별자치도 서귀포시 안덕면 동광로 267-7,167,175,221,563,188
462,관광지,석부작박물관,제주특별자치도 서귀포시 일주동로 8941 (호근동),210,160,191,561,187
1015,관광지,평대해변,제주특별자치도 제주시 구좌읍 평대리 1994-20,133,127,298,558,186
292,관광지,문섬(서귀포해양도립공원),제주특별자치도 서귀포시 칠십리로,185,189,183,557,186
752,관광지,정물오름,제주특별자치도 제주시 한림읍 금악리 산 52-1,229,182,147,558,186
543,관광지,시크릿가든촬영지,제주특별자치도 서귀포시 중문관광로 198 (중문동),186,173,200,559,186
369,관광지,붉은오름(표선면),제주특별자치도 서귀포시 표선면 남조로 1487-73,252,144,163,559,186
338,관광지,베릿네오름,제주특별자치도 서귀포시 중문상로17번길 51,226,181,151,558,186
938,관광지,진아영 할머니 집터,제주특별자치도 제주시 한림읍 월령1길 22,228,158,172,558,186
149,관광지,노루생태관찰원,제주특별자치도 제주시 명림로 520,176,157,226,559,186
152,관광지,노을해안1014,제주특별자치도 제주시 한경면 노을해안로 1014,175,161,217,553,184
1386,숙박,대명 샤인빌리조트,제주특별자치도 서귀포시 표선면 일주동로 6347-17,202,170,177,549,183
279,관광지,무릉곶자왈,제주특별자치도 서귀포시 대정읍 무릉리 산 1,207,173,169,549,183
1740,숙박,아이랑키즈펜션,제주특별자치도 제주시 애월읍 고내로7길 34,196,129,225,550,183
3275,음식점,우유부단,제주특별자치도 제주시 한림읍 금악동길 38,150,219,176,545,182
137,관광지,낙타트래킹,제주특별자치도 서귀포시 표선면 번영로 2564-21,176,178,189,543,181
1034,관광지,하도리 철새도래지,제주특별자치도 제주시 구좌읍 하도리 53-2,230,167,146,543,181
3131,음식점,앤트러사이트,제주특별자치도 제주시 한림읍 한림로 564,197,177,166,540,180
467,관광지,설쿰바당,제주특별자치도 서귀포시 안덕면 사계리,133,95,307,535,178
185,관광지,대정해변(하모해변),제주특별자치도 서귀포시 대정읍 하모리,155,123,256,534,178
10,관광지,SM 디지털아트 뮤지엄,제주특별자치도 제주시 애월읍 애월해안로 516-7,184,168,183,535,178
2378,음식점,노조미,제주특별자치도 제주시 국기로2길 2-3,306,77,150,533,178
1063,관광지,함덕잠수함(이고제주),제주특별자치도 제주시 조천읍 조함해안로 378,159,166,210,535,178
493,관광지,세리월드 테마파크,제주특별자치도 서귀포시 법환상로2번길 97-13,183,155,191,529,176
798,관광지,제주목관아,제주특별자치도 제주시 관덕로 25,174,182,171,527,176
841,관광지,제주올레 15-B코스,제주특별자치도 제주시 한림읍 한림해안로 192,207,189,133,529,176
2729,음식점,미풍해장국 신제주점,제주특별자치도 제주시 선덕로 2,140,118,270,528,176
839,관광지,제주올레 14코스,제주특별자치도 제주시 한림읍 월령리 산 9-15,206,158,163,527,176
97,관광지,그린크루즈(산방산유람선),제주특별자치도 서귀포시 안덕면 화순해안로106번길 16,202,157,168,527,176
296,관광지,"물메(물미, 수산봉)",제주특별자치도 제주시 애월읍 수산리 산 1-1,192,154,181,527,176
3242,음식점,요리하는 목수,제주특별자치도 제주시 애월읍 애월해안로 664,160,182,186,528,176
3126,음식점,애월더선셋,제주특별자치도 제주시 애월읍 일주서로 6111,155,210,161,526,175
3411,음식점,제주맥주 양조장,제주특별자치도 제주시 한림읍 금능농공길 62-11,155,116,248,519,173
916,관광지,종달리해변,제주특별자치도 제주시 구좌읍 종달리 565-72,184,134,199,517,172
700,관광지,월대천,제주특별자치도 제주시 월대6길 5,98,162,255,515,172
1325,숙박,나날 게스트하우스,제주특별자치도 서귀포시 남성중로121번길 14,156,182,178,516,172
1004,관광지,톨칸이,제주특별자치도 제주시 우도면 연평리 1732-1,233,129,154,516,172
3549,음식점,최고집,제주특별자치도 서귀포시 김정문화로 71,139,217,157,513,171
800,관광지,제주미래교육연구원 과학탐구체험장,제주특별자치도 제주시 산록북로 421,150,180,184,514,171
2265,음식점,고집돌우럭(중문),제주특별자치도 서귀포시 일주서로 879,163,184,165,512,171
851,관광지,제주올레 3코스,제주특별자치도 서귀포시 표선면 하천리 87-1,245,142,122,509,170
636,관광지,영주산,제주특별자치도 서귀포시 표선면 번영로,262,130,118,510,170
477,관광지,성산오조리해안,제주특별자치도 거쉬포시 성산읍 한도로,176,167,166,509,170
61,관광지,고흐의 정원,제주특별자치도 서귀포시 성산읍 삼달신풍로 126-5,192,156,160,508,169
321,관광지,방림원,제주특별자치도 제주시 한경면 용금로 864,185,179,144,508,169
866,관광지,제주제트,제주특별자치도 서귀포시 대포로 172-5,144,129,233,506,169
1060,관광지,한화리조트 테라피센터,제주특별자치도 제주시 명림로 575-107 한화리조트 로비층 지하,182,142,182,506,169
335,관광지,법화사,제주특별자치도 서귀포시 하원북로 35번길 15-28,167,118,222,507,169
476,관광지,성산~세화 해안도로,제주특별자치도 서귀포시 성산읍 해맞이해안로 2636,197,151,159,507,169
2286,음식점,구좌상회,제주특별자치도 제주시 구좌읍 월정1길 55,139,206,162,507,169
2072,숙박,포도호텔,제주특별자치도 서귀포시 안덕면 산록남로 863,179,168,156,503,168
115,관광지,김녕금속공예벽화마을,제주특별자치도 제주시 구좌읍 김녕항3길 18-16,189,137,177,503,168
2843,음식점,붉은제주,제주특별자치도 제주시 애월읍 애월로 37,162,168,173,503,168
145,관광지,납읍난대림 금산공원,제주특별자치도 제주시 애월읍 납읍리 14 57,199,147,158,504,168
45,관광지,걸매생태공원,제주특별자치도 서귀포시 남성로 (서홍동),195,126,182,503,168
526,관광지,쇠와꽃 승마장,제주특별자치도 서귀포시 성산읍 섭지코지로25번길 88-17,172,169,163,504,168
2043,숙박,틸다하우스,제주특별자치도 제주시 한경면 중산간서로 3367-1,151,175,179,505,168
1665,숙박,소풍(월정리),제주특별자치도 제주시 구좌읍 월정1길 23,137,175,193,505,168
989,관광지,클럽나인브릿지,제주특별자치도 서귀포시 안덕면 광평로 34-156,180,152,169,501,167
974,관광지,취다선리조트,제주특별자치도 서귀포시 성산읍 해맞이해안로 2688,177,182,143,502,167
3155,음식점,어진이네횟집,제주특별자치도 서귀포시 보목포로 93,149,161,191,501,167
121,관광지,김녕해안도로,제주특별자치도 제주시 구좌읍 김녕리,194,133,173,500,167
1038,관광지,하모씨워킹,제주특별자치도서귀포시대정읍최남단해안로 130,103,140,259,502,167
2071,숙박,포구민박,제주시 애월읍 하귀12길 20-1,140,187,172,499,166
386,관광지,사계 용머리해안 (해산물),제주특별자치도 서귀포시 안덕면 사계남로216번길 28,208,136,153,497,166
249,관광지,마라도성당,제주특별자치도 서귀포시 대정읍 마라로 153,179,164,152,495,165
549,관광지,신산공원,제주특별자치도 제주시 신산로 92-12,256,124,116,496,165
71,관광지,곽지해수욕장야영장,제주특별자치도 제주시 애월읍 곽지리 1565,148,158,190,496,165
790,관광지,제주돌하르방캠핑장,제주특별자치도 제주시 한경면 낙수로 271-40,156,170,168,494,165
2663,음식점,명월국민학교,제주특별자치도 제주시 한림읍 명월로 48,195,137,162,494,165
709,관광지,월평포구,제주특별자치도 서귀포시 말질로 462,160,134,202,496,165
2006,숙박,캠핑트리펜션,제주특별자치도 제주시 애월읍 광상로 115,173,184,136,493,164
239,관광지,렛츠런파크,제주특별자치도 제주시 애월읍 평화로 2144,153,176,164,493,164
994,관광지,태웃개,제주특별자치도 서귀포시 남원읍 태위로398번길 57,105,98,289,492,164
1033,관광지,하늘여행 행글라이더체험장,제주특별자치도 서귀포시 안덕면 중산간서로 1877,202,144,140,486,162
15,관광지,가마오름 진지동굴,제주특별자치도 제주시 한경면 청수서5길 63,152,142,192,486,162
1230,쇼핑,표선오일시장,제주특별자치도 서귀포시 표선면 표선동서로 203-1,159,131,194,484,161
3849,음식점,흑돈가,제주특별자치도 제주시 한라대학로 11,159,150,173,482,161
1069,관광지,해녀의 태왁,제주특별자치도 제주시 구좌읍 김송로 94,132,166,186,484,161
2952,음식점,섭지코지 해녀밥상,제주특별자치도 서귀포시 성산읍 신양로122번길 60-6,178,152,154,484,161
1070,관광지,해맞이해안로,제주특별자치도 제주시 구좌읍 김녕리,171,127,183,481,160
257,관광지,막숙,제주특별자치도 서귀포시 막숙포로37번길 2,124,123,232,479,160
404,관광지,산지등대,제주특별자치도 제주시 사라봉동길 108-1 (건입동),185,151,143,479,160
829,관광지,제주여가마을,제주특별자치도 제주시 조천읍 조와로 360,174,154,153,481,160
391,관광지,사라봉공원,제주특별자치도 제주시 사라봉동길 74 (건입동),220,131,129,480,160
763,관광지,제주 이호털보 배낚시,제주시 테우해안로 146,178,125,175,478,159
980,관광지,캔디원,제주특별자치도 제주시 조천읍 선교로 384,161,137,180,478,159
622,관광지,엉알해안,제주특별자치도 제주시 한경면 고산리 3427-33,139,152,182,473,158
169,관광지,단산(바굼지오름),제주특별자치도 서귀포시 안덕면 향교로 165-23,194,152,127,473,158
2915,음식점,상춘재,제주특별자치도 제주시 조천읍 선진길 26,181,157,135,473,158
489,관광지,섶섬(서귀포해양도립공원),제주특별자치도 서귀포시 마소물로,170,150,152,472,157
122,관광지,김만덕객주,제주특별자치도 제주시 임항로 68,148,134,189,471,157
2526,음식점,땅꼬분식 뷔페,제주특별자치도 제주시 조천읍 조천18길 50-9,198,125,148,471,157
3749,음식점,하하호호(HAHAHOHO),제주특별자치도 제주시 우도면 우도해안길 532,119,217,135,471,157
893,관광지,제주힐CC,제주특별자치도 제주시 516로 2596-117,161,146,161,468,156
660,관광지,옷귀마테마타운,제주특별자치도 서귀포시 남원읍 서성로 955-117,151,159,159,469,156
711,관광지,위미항,제주특별자치도 서귀포시 남원읍 위미중앙로196번길 6-13,144,168,155,467,156
135,관광지,낙천리아홉굿의자마을,제주시 한경면 낙수로 97,165,156,143,464,155
50,관광지,게우지코지,제주특별자치도 서귀포시 하효동,152,152,158,462,154
256,관광지,마흐니 숲길,제주특별자치도 서귀포시 남원읍 남조로 973,173,153,137,463,154
571,관광지,쌍용굴(한림공원),제주특별자치도 제주시 한림읍 한림로 300,156,143,164,463,154
603,관광지,애월 하물,제주특별자치도 제주시 애월읍 애월로11길 6,156,132,175,463,154
3400,음식점,제주그림카페,제주특별자치도 서귀포시 안덕면 녹차분재로 218 4층,142,158,159,459,153
212,관광지,돔베낭길,제주특별자치도 서귀포시 태평로92번길 49,155,148,155,458,153
776,관광지,제주글램핑 (무한자미향),제주특별자치도 제주시 구좌읍 중산간동로 1921,153,152,151,456,152
1019,관광지,포레스트 사파리,제주특별자치도 제주시 조천읍 선교로 474-1,158,126,172,456,152
2841,음식점,북촌에가면,제주특별자치도 제주시 조천읍 북촌5길 6,227,146,82,455,152
2291,음식점,국수의전설,제주특별자치도 서귀포시 효돈로 108,144,158,153,455,152
952,관광지,천주교 순례길 - 김대건길,제주특별자치도 제주시 한경면 고산로 6-3,172,153,129,454,151
191,관광지,더 플래닛(THE PLANET),제주특별자치도 서귀포시 천제연로 70,145,132,177,454,151
655,관광지,옥돔마을,제주특별자치도 서귀포시 남원읍 남태해안로 508,168,138,143,449,150
708,관광지,월정리해안도로,제주특별자치도 제주시 구좌읍 월정리 652-4,179,121,149,449,150
1724,숙박,씨에스호텔앤리조트,제주특별자치도 서귀포시 중문관광로 198,146,143,160,449,150
82,관광지,구좌 하도어촌계,제주특별자치도 제주시 구좌읍 해맞이해안로 1897-27,120,133,198,451,150
2506,음식점,동복리해녀촌,제주특별자치도 제주시 구좌읍 동복로 33,148,141,162,451,150
3012,음식점,수우동,제주특별자치도 제주시 한림읍 협재1길 11,125,185,141,451,150
846,관광지,제주올레 19코스,제주특별자치도 제주시 조천읍 조천리 1142,152,149,148,449,150
1110,관광지,흑돼지거리,제주특별자치도 제주시 건입동,168,127,152,447,149
805,관광지,제주별빛누리공원[제한적운영중],제주특별자치도 제주시 선돌목동길 60,161,131,155,447,149
51,관광지,고근산(고공산),제주특별자치도 서귀포시 고근산로202번길 48,145,155,146,446,149
445,관광지,서귀포시립기당미술관,제주특별자치도 서귀포시 남성중로153번길 15,176,133,139,448,149
3763,음식점,한림칼국수,제주특별자치도 제주시 한림읍 한림해안로 141,151,143,154,448,149
3007,음식점,수두리보말칼국수,제주특별자치도 서귀포시 천제연로 192,204,127,113,444,148
3476,음식점,중문랜드프리미엄뷔페,제주특별자치도 서귀포시 소보리당로164번길 62,141,132,171,444,148
2331,음식점,김지순의 낭푼밥상,제주특별자치도 제주시 연동6길 28,156,150,136,442,147
820,관광지,제주신화전설탐방로,제주특별자치도 서귀포시 안덕면 녹차분재로 218,169,149,123,441,147
456,관광지,서복전시관,제주특별자치도 서귀포시 칠십리로 156-8,148,138,155,441,147
836,관광지,제주올레 12코스,제주특별자치도 서귀포시 대정읍 신도리 2883-2,159,152,129,440,147
40,관광지,거슨새미오름,제주특별자치도 제주시 구좌읍 송당리 산 145,217,113,107,437,146
864,관광지,제주잠수함(국제리더스클럽),제주특별자치도 제주시 조천읍 조함해안로 321-21,125,123,190,438,146
895,관광지,제지기오름,제주특별자치도 서귀포시 보목동 275-1,175,135,127,437,146
1502,숙박,마이테르유스호스텔,제주특별자치도 제주시 애월읍 애원로 474-29,109,117,212,438,146
274,관광지,모진이몽돌해변,제주특별자치도 제주시 추자면 신양리 56,141,143,155,439,146
826,관광지,제주양떼목장,제주특별자치도 제주시 애월읍 도치돌길 289-13,125,170,142,437,146
199,관광지,도두항,제주특별자치도 제주시 도공로 2,161,140,136,437,146
1450,숙박,라마다프라자 제주호텔,제주특별자치도 제주시 탑동로 66,152,118,165,435,145
460,관광지,서중천탐방로,제주특별자치도 서귀포시 남원읍 서성로 755,225,107,102,434,145
731,관광지,이호털보네배낚시,제주특별자치도 제주시 이호1동 1787,132,133,171,436,145
502,관광지,소라의성,제주특별자치도 서귀포시 칠십리로214번길 17-17,152,124,159,435,145
1274,숙박,갤럭시호텔 제주,제주특별자치도 제주시 남성로 33,119,152,160,431,144
1017,관광지,평화통일 불사리탑,제주특별자치도 제주시 조천읍 일주동로 884,179,125,127,431,144
605,관광지,애월스쿠버다이빙스쿨,제주특별자치도 제주시 애월읍 애월로13길 45,119,96,217,432,144
1235,쇼핑,한림매일시장,제주특별자치도 제주시 한림읍 한림로 687,130,146,155,431,144
959,관광지,청수성결교회,제주특별자치도 제주시 한경면 대한로 1067,135,138,159,432,144
331,관광지,백조일손지묘(백조일손지지),제주특별자치도 서귀포시 안덕면 사계리,191,121,118,430,143
444,관광지,서귀포농업기술센터 제주농업생태원,제주특별자치도 서귀포시 남원읍 중산간동로 7413,199,123,107,429,143
348,관광지,보목포구,제주특별자치도 서귀포시 보목포로 46,157,118,154,429,143
3851,음식점,흑돼지구이집 하영,제주특별자치도 서귀포시 천제연로 101,145,151,134,430,143
583,관광지,아이리스촬영지(하얀등대),제주특별자치도 서귀포시 표선면,150,157,121,428,143
770,관광지,제주교육박물관,제주특별자치도 제주시 오복 4길 25,134,143,152,429,143
108,관광지,기독교순례길 1코스(순종의길),제주특별자치도 제주시 애월읍 금성하안길 3,127,157,141,425,142
144,관광지,남원항 (남원포구),제주특별자치도 서귀포시 남원읍 남태해안로 140,152,161,113,426,142
767,관광지,제주고산리유적,제주특별자치도 제주시 한경면 노을해안로 1100,140,136,149,425,142
451,관광지,서귀포층패류화석산지,제주특별자치도 서귀포시 남성중로 43,158,139,130,427,142
727,관광지,이중섭거주지,제주특별자치도 서귀포시 이중섭로 29,162,138,125,425,142
2455,음식점,덕인당보리빵 제주점,제주특별자치도 제주시 연삼로 180,271,81,73,425,142
1836,숙박,월령채,제주특별자치도 제주시 한림읍 월령3길 27-5,41,56,329,426,142
21,관광지,가파도 마라도 정기여객선,제주특별자치도 서귀포시 대정읍 최남단해안로 120,157,126,142,425,142
2855,음식점,비밀의숲 카페,제주특별자치도 제주시 구좌읍 송당리 산 66-2,143,121,163,427,142
777,관광지,제주기독교순례길,제주특별자치도 제주시 애월읍 금성하안길 3,143,135,149,427,142
1046,관광지,한라산 아래 첫 마을,제주특별자치도 서귀포시 안덕면 광평로 41,167,134,123,424,141
2928,음식점,서귀포네거리식당,제주특별자치도 서귀포시 서문로29번길 20,159,131,133,423,141
779,관광지,제주난타,제주특별자치도 제주시 선돌목동길 56-26,153,123,148,424,141
1480,숙박,롯데호텔 제주,제주특별자치도 서귀포시 중문관광로72번길 35,137,169,116,422,141
944,관광지,참살이마을 명도암 농어촌체험마을,제주시 명림로 268-71,158,151,113,422,141
3366,음식점,잠녀해녀촌,제주특별자치도 제주시 조천읍 조함해안로 410,144,132,145,421,140
858,관광지,제주올레 9코스,제주특별자치도 서귀포시 안덕면 감산리 982-2,171,120,129,420,140
2726,음식점,미친부엌,제주특별자치도 제주시 탑동로 15,128,127,162,417,139
378,관광지,비자림농원,제주특별자치도 제주시 조천읍 선흘동1길 31-71,158,136,122,416,139
190,관광지,대한민국최남단기념비/ 마라도 기념비,제주특별자치도 서귀포시 대정읍 마라로 131,144,128,146,418,139
1571,숙박,벙커호텔앤리조트,제주특별자치도 서귀포시 중산간동로8183번길 16,95,79,243,417,139
164,관광지,다랑쉬굴,제주특별자치도 제주시 구좌읍 세화리 2608-6,177,132,109,418,139
868,관광지,제주중앙성당,제주특별자치도 제주시 관덕로8길 14,148,137,133,418,139
635,관광지,영실기암,제주특별자치도 서귀포시 하원동,153,154,108,415,138
472,관광지,성김대건신부표착기념관,제주특별자치도 제주시 한경면 용수1길 108,148,121,145,414,138
788,관광지,제주돌마을공원,제주특별자치도 제주시 한림읍 금능남로 421,145,129,140,414,138
697,관광지,원앙카라반캠핑장앤야영장,제주특별자치도 서귀포시 돈내코로 120,136,127,151,414,138
3342,음식점,인디언키친,제주특별자치도 제주시 애월읍 애원로 191,135,108,172,415,138
438,관광지,서광승마장,제주특별자치도 서귀포시 안덕면 녹차분재로 239,125,129,161,415,138
860,관광지,제주워터월드,제주특별자치도 서귀포시 월드컵로 33,115,120,177,412,137
877,관광지,제주토종흑염소목장,제주특별자치도 서귀포시 남원읍 자배오름로 74-274,140,125,147,412,137
1395,숙박,더본 호텔,제주도 서귀포시 색달로 18,152,134,124,410,137
1910,숙박,제주부영청소년수련원,제주특별자치도 서귀포시 중문상로17번길 52-17,139,144,127,410,137
267,관광지,명월성지,제주특별자치도 제주시 한림읍 명월리 2236,162,111,137,410,137
2834,음식점,부두식당 (모슬포),제주특별자치도 서귀포시 대정읍 하모항구로 62,178,113,121,412,137
466,관광지,선흘1리,제주특별자치도 제주시 조천읍 중산간동로 1280,150,141,121,412,137
630,관광지,연화못,제주특별자치도 제주시 애월읍 고하상로,123,114,175,412,137
3067,음식점,신설오름,제주특별자치도 제주시 고마로17길 2,127,147,136,410,137
123,관광지,김만덕기념관,제주특별자치도 제주시 산지로 7,149,120,138,407,136
63,관광지,곤흘동(곤을동) 마을터,제주특별자치도 제주시 화북1동 4438,167,149,88,404,135
158,관광지,높은오름,제주특별자치도 제주시 구좌읍 송당리 산 213-1,204,101,101,406,135
695,관광지,원당봉,제주특별자치도 제주시 원당로16길 16-30,148,155,103,406,135
3018,음식점,숙이네보리빵,제주특별자치도 제주시 애월읍 애월로 118,212,81,112,405,135
3196,음식점,오는정김밥,제주특별자치도 서귀포시 동문동로 2,205,100,101,406,135
2742,음식점,바다속고등어쌈밥,제주특별자치도 제주시 애월읍 일주서로 7089,174,114,118,406,135
30,관광지,갓전시관[갓전수교육관],제주특별자치도 제주시 조천읍 남조로 1904,139,122,142,403,134
794,관광지,제주레이크힐스컨트리클럽,제주특별자치도 서귀포시 산록남로 1391 (중문동),122,118,161,401,134
341,관광지,별도봉,제주특별자치도 제주시 선반로 (화북일동),145,135,121,401,134
510,관광지,손지오름,제주특별자치도 제주시 구좌읍 종달리 산 52,212,101,88,401,134
990,관광지,타보카 월정리투명카약,제주특별자치도 제주시 구좌읍 월정리 1400-4,115,115,172,402,134
937,관광지,진빌레 밭담길,제주특별자치도 제주시 구좌읍 월정리 1400-14,139,136,128,403,134
739,관광지,자구내포구,제주특별자치도 제주시 한경면 고산리,124,127,151,402,134
313,관광지,바릇스파,제주특별자치도 제주시 한림읍 한림로 392 3층,134,123,143,400,133
1021,관광지,표선세화해안도로,제주특별자치도 서귀포시 표선면 표선리,136,125,137,398,133
9,관광지,M1971 요트투어,제주특별자치도 서귀포시 대정읍 최남단해안로 128,115,129,155,399,133
1392,숙박,더들집,제주특별자치도 제주시 구좌읍 동복로1길 23-3,171,144,84,399,133
236,관광지,라온주 실내체험동물원,제주특별자치도 제주시 한림읍 월림7길 155,136,115,149,400,133
1100,관광지,황금굴(한림공원),제주특별자치도 제주시 한림읍 한림로 300,129,133,136,398,133
783,관광지,제주다이브 체험다이빙,제주특별자치도 서귀포시 월드컵로 84,108,113,178,399,133
849,관광지,제주올레 21코스,제주특별자치도 제주시 구좌읍 하도리 3204-1,119,150,131,400,133
130,관광지,꽃썸,서귀포시 안덕면 동광로 151,153,153,90,396,132
810,관광지,제주불교성지 순례길 절로가는길 - 선정의 길,제주특별자치도 서귀포시 516로771번길 59,147,108,141,396,132
193,관광지,더마카트,제주특별자치도 제주시 한림읍 월림7길 155,112,136,149,397,132
92,관광지,귤빛캠핑장,제주특별자치도 제주시 조천읍 함와로 428,155,129,112,396,132
138,관광지,남내소,제주특별자치도 서귀포시 남원읍 하례로,133,135,127,395,132
1938,숙박,제주유스호스텔,제주특별자치도 제주시 애월읍 방축길 128,181,114,101,396,132
58,관광지,고씨주택,제주특별자치도 제주시 관덕로17길 27-1,129,140,128,397,132
1061,관광지,함덕백사장 & 서우봉,제주특별자치도 제주시 조천읍 조함해안로 519-10,140,129,128,397,132
1984,숙박,쫄깃센터,제주특별자치도 제주시 한림읍 협재1길 27,128,136,130,394,131
848,관광지,제주올레 20코스,제주특별자치도 제주시 구좌읍 행원동길 22,146,140,107,393,131
1463,숙박,랜딩관 제주신화월드 호텔앤리조트,제주특별자치도 서귀포시 안덕면 신화역사로304번길 38,154,132,108,394,131
1058,관광지,한림해안도로,제주특별자치도 제주시 한림읍 귀덕리,131,125,138,394,131
3580,음식점,카페공작소,제주특별자치도 제주시 구좌읍 해맞이해안로 1446,85,187,120,392,131
1067,관광지,해거름전망대,제주특별자치도 제주시 한경면 일주서로 4641,136,128,128,392,131
638,관광지,예래생태체험관,제주특별자치도 서귀포시 예래로 213,137,116,137,390,130
813,관광지,제주사랑방(제주책방),제주특별자치도 제주시 관덕로17길 27-1,151,111,129,391,130
960,관광지,청초밭영농조합법인,제주특별자치도 서귀포시 표선면 성읍이리로57번길 34,140,125,125,390,130
842,관광지,제주올레 16코스,제주특별자치도 제주시 애월읍 고내리 1111-2,145,136,109,390,130
515,관광지,송당본향당,제주특별자치도 제주시 구좌읍 송당리,151,121,117,389,130
579,관광지,아라리오뮤지엄탑동시네마,제주특별자치도 제주시 삼도2동 1261-8,147,109,133,389,130
618,관광지,어영공원,제주특별자치도 제주시 서해안로 452 (맞은편 공원),123,134,131,388,129
987,관광지,큰바리메오름,제주특별자치도 제주시 애월읍 산록서로 15,178,115,94,387,129
537,관광지,쉼터마을 유수암리 농어촌체험마을,제주특별자치도 제주시 애월읍 유수암평화길 14,122,148,117,387,129
34,관광지,개오름,제주특별자치도 서귀포시 표선면 성읍이리로57번길 162,135,123,130,388,129
828,관광지,제주에코승마장(구.제주승마장),제주특별자치도 제주시 조천읍 교래리 39-3번지 (비자림로 1065),136,116,134,386,129
2450,음식점,더파크뷰(신라호텔),제주특별자치도 서귀포시 중문관광로72번길 75,167,110,109,386,129
3750,음식점,하효살롱,제주특별자치도 서귀포시 효돈순환로 217-8,140,119,129,388,129
772,관광지,제주국제공항(정뜨르비행장),제주특별자치도 제주시 공항로 2,143,116,129,388,129
235,관광지,라온승마클럽,제주특별자치도 제주시 한림읍 월림7길 155,124,122,139,385,128
437,관광지,서광리 곶자왈생태탐방로,서귀포시 안덕면 서광리 산6-1,185,97,102,384,128
350,관광지,보통청춘기록실 청춘사진관,제주특별자치도 제주시 한림읍 귀덕11길 1,144,104,135,383,128
2902,음식점,삼다도횟집,제주특별자치도 제주시 서해안로 572,120,125,139,384,128
345,관광지,병악현무암지대,제주특별자치도 서귀포시 안덕면 사계리,138,124,119,381,127
687,관광지,우도스쿠터여행,제주특별자치도 제주시 우도면 2395-5,149,106,127,382,127
165,관광지,다랑쉬마을,제주특별자치도 제주시 구좌읍 다랑쉬로 406-25,150,115,116,381,127
2910,음식점,삼성혈해물탕,제주특별자치도 제주시 선덕로5길 20,136,140,105,381,127
663,관광지,와흘본향당,제주특별자치도 제주시 조천읍 와흘리 1274-1,134,121,125,380,127
1640,숙박,서귀포KAL호텔,제주특별자치도 서귀포시 칠십리로 242,112,135,133,380,127
1018,관광지,포도갤러리 in 포도호텔,제주특별자치도 서귀포시 안덕면 산록남로 863 포도호텔 지하1층,135,110,135,380,127
1088,관광지,형제해안도로,제주특별자치도 서귀포시 대정읍 상모리 1649-1,149,111,122,382,127
3303,음식점,위미항활어회센터,제주특별자치도 서귀포시 남원읍 위미중앙로196번길 6-37,131,124,126,381,127
765,관광지,제주 패러글라이딩 스쿨,"제주특별자치도 제주시 신선길 17-6, 일도주택3층(일도2동)",134,100,146,380,127
2192,숙박,히든클리프 호텔 앤 네이쳐,제주특별자치도 서귀포시 예래해안로 542,109,164,107,380,127
2892,음식점,산방식당(모슬포본점),제주특별자치도 서귀포시 대정읍 하모이삼로 62,113,135,132,380,127
832,관광지,제주올레 1-1코스,제주특별자치도 제주시 우도면 연평리 2473-1,139,122,119,380,127
915,관광지,종달리전망대,제주특별자치도 제주시 구좌읍 해맞이해안로 2196,133,114,130,377,126
542,관광지,스프링데일CC,제주특별자치도 서귀포시 남원읍 서성로 459번지,150,114,113,377,126
2550,음식점,레이식당,제주특별자치도 제주시 구좌읍 해맞이해안로 1156-5,126,105,147,378,126
685,관광지,우도봉 풍경,제주특별자치도 제주시 우도면 연평리 1,139,121,119,379,126
492,관광지,세계조가비박물관,제주특별자치도 서귀포시 태평로 284,130,112,136,378,126
1619,숙박,비젠빌리지,제주특별자치도 제주시 구좌읍 하도9길 72,95,152,130,377,126
1374,숙박,다인오세아노 호텔,제주특별자치도 제주시 애월읍 애월해안로 394,116,136,126,378,126
374,관광지,비양도 연평리 야영지,제주특별자치도 제주시 우도면 연평리 3,141,118,119,378,126
1170,쇼핑,선물고팡,제주특별자치도 제주시 월성로 15,120,109,149,378,126
351,관광지,본초족욕,제주특별자치도 제주시 은수길 65,160,116,103,379,126
1845,숙박,유심이감성하우스민박,제주특별자치도 제주시 추자면 추자로 78,117,124,137,378,126
1226,쇼핑,탐라동주,제주특별자치도 서귀포시 중문관광로 224,108,131,137,376,125
1104,관광지,효명사,제주특별자치도 서귀포시 남원읍 516로 815-41,125,122,127,374,125
979,관광지,캐릭파크,제주특별자치도 제주시 조천읍 선교로 266,121,118,135,374,125
2658,음식점,명랑스낵,제주특별자치도 제주시 한림읍 한림로 585,89,171,114,374,125
1645,숙박,서귀포힐즈호텔,제주특별자치도 서귀포시 신서로48번길 50,81,124,170,375,125
647,관광지,오래물,제주특별자치도 제주시 도공로 2,76,71,227,374,125
364,관광지,북촌환해장성,제주특별자치도 제주시 조천읍 북촌리,219,74,80,373,124
421,관광지,삼의악트레킹코스,제주특별자치도 제주시 아라동 산 24-2,147,123,103,373,124
762,관광지,제주 삼양동 유적,제주특별자치도 제주시 선사로2길 13 (삼양일동),130,121,120,371,124
1497,숙박,마레보 리조트,제주특별자치도 제주시 애월읍 신엄안3길 135,115,121,136,372,124
3321,음식점,은희네해장국(일도점),제주특별자치도 제주시 고마로13길 8,113,124,134,371,124
2628,음식점,맛나식당,제주특별자치도 서귀포시 성산읍 동류암로 43,130,119,122,371,124
231,관광지,디스커버제주,제주특별자치도 서귀포시 대포로 26,120,121,130,371,124
157,관광지,농개,제주특별자치도 서귀포시 성산읍 환해장성로111번길 4,97,92,183,372,124
859,관광지,제주우리병원,제주특별자치도 제주시 중앙로 373,132,132,106,370,123
297,관광지,물뫼힐링팜,제주특별자치도 제주시 애월읍 예원로 51,136,108,124,368,123
1615,숙박,비안,제주특별자치도 제주시 조천읍 중산간동로 1197-16,97,147,125,369,123
562,관광지,신풍리 밭담길,제주특별자치도 서귀포시 성산읍 신풍하동로 39,136,112,121,369,123
833,관광지,제주올레 10-1코스,제주특별자치도 서귀포시 대정읍 가파리 298,126,129,113,368,123
613,관광지,약천사 템플스테이,제주특별자치도 서귀포시 이어도로 293-28 (대포동),141,132,92,365,122
514,관광지,송당리,제주특별자치도 제주시 구좌읍 중산간동로 2218-3,115,134,116,365,122
629,관광지,연북정,제주특별자치도 제주시 조천읍 조천리 2690,119,122,126,367,122
1487,숙박,리니민박(RINY),제주특별자치도 서귀포시 표선면 성읍민속로149번길 1,110,133,124,367,122
855,관광지,제주올레 7-1코스,제주특별자치도 서귀포시 서호동 553-1,136,116,114,366,122
490,관광지,세계술박물관,제주특별자치도 서귀포시 표선면 한마음초등로 431,120,131,114,365,122
151,관광지,노을승마장,제주특별자치도 제주시 우도면 우도해안길 406-1,135,96,133,364,121
271,관광지,모슬봉 (모슬개오름),제주특별자치도 서귀포시 대정읍 상모로191번길,145,105,114,364,121
1168,쇼핑,서문공설시장,제주특별자치도 제주시 서문로4길 13-2,144,133,87,364,121
899,관광지,조안베어뮤지엄,제주특별자치도 서귀포시 대포로 113 (대포동),116,104,142,362,121
0,관광지,(주)제주해양레저 투명카약,제주특별자치도 제주시 애월읍 애월로1길 22,97,104,161,362,121
3435,음식점,제주올레냉면 제주노형점,제주특별자치도 제주시 광평동로 19,104,111,149,364,121
529,관광지,수산저수지,제주특별자치도 제주시 애월읍 수산리 1,127,121,114,362,121
659,관광지,올레캠프 본점 알파캠프,제주특별자치도 서귀포시 성산읍 고성오조로 106,115,131,117,363,121
2739,음식점,바다다,제주특별자치도 서귀포시 대포로 148-15,92,167,102,361,120
268,관광지,명월팽나무군락,제주특별자치도 제주시 한림읍 명월로 71,129,114,118,361,120
592,관광지,안덕면 사계어촌계,제주특별자치도 서귀포시 안덕면 형제해안로 20,145,106,109,360,120
2893,음식점,산지물식당(건입동본점),제주특별자치도 제주시 임항로 26 (건입동),121,111,129,361,120
146,관광지,내창트레킹,제주특별자치도 서귀포시 남원읍 하례중앙로 95,116,120,124,360,120
835,관광지,제주올레 11코스,제주특별자치도 서귀포시 대정읍 동일리 3168,135,109,117,361,120
428,관광지,새별헤이요목장,제주도 제주시 애월읍 봉성리 4554-20,121,130,110,361,120
3818,음식점,협재해녀의집,제주특별자치도 제주시 한림읍 협재3길 19,122,109,130,361,120
2961,음식점,성산 고등어쌈밥 김치찜,제주특별자치도 서귀포시 성산읍 섭지코지로25번길 122-5,126,104,131,361,120
408,관광지,산천단,제주특별자치도 제주시 아라1동 392-3,126,114,121,361,120
457,관광지,서부두명품횟집거리,제주특별자치도 제주시 서부두길 16,131,103,122,356,119
311,관광지,바당미술관,제주특별자치도 서귀포시 대정읍 노을해안로 96,109,120,128,357,119
2255,음식점,고마워토토 아뜰리에,제주특별자치도 제주시 애월읍 고성북길 112,118,120,120,358,119
1085,관광지,협재포구,제주특별자치도 제주시 한림읍 협재리,108,114,131,353,118
824,관광지,제주아트센터,제주특별자치도 제주시 오남로 231,114,141,99,354,118
2656,음식점,명당양과,제주시 원노형로 83,127,108,120,355,118
690,관광지,우도징기스칸승마체험,제주특별자치도 제주시 우도면 우도해안길 446,133,96,126,355,118
162,관광지,느지리오름(망오름),제주특별자치도 제주시 한림읍 상명리 산 5,128,113,113,354,118
757,관광지,제라진 제주오프로드 사파리,제주특별자치도 제주시 조천읍 선교로 33,116,125,112,353,118
656,관광지,온평리 포구,제주특별자치도 서귀포시 성산읍 온평리,114,109,131,354,118
362,관광지,북촌리 4.3길,제주특별자치도 제주시 조천읍 북촌3길 3,146,126,83,355,118
319,관광지,발자국화석공원,제주특별자치도 서귀포시 대정읍 형제해안로 192,134,122,96,352,117
2244,음식점,경미네집(경미휴게소),제주특별자치도 서귀포시 성산읍 일출로 259,101,100,150,351,117
177,관광지,당케산물(당케포구),제주특별자치도 서귀포시 표선면 표선당포로,140,102,109,351,117
475,관광지,성산 유채꽃재배단지,제주특별자치도 서귀포시 성산읍 일출로,139,104,107,350,117
615,관광지,어린이교통공원,제주특별자치도 제주시 명림로 437 (봉개동 4.3 공원 맞은편),109,128,112,349,116
2252,음식점,고래라면,제주특별자치도 서귀포시 성산읍 삼달로 104,117,104,126,347,116
32,관광지,강정어촌계,제주특별자치도 서귀포시 말질로 290,113,119,117,349,116
747,관광지,전농로 서사라문화거리,제주특별자치도 제주시 서사로7길 27,178,88,83,349,116
174,관광지,당오름,제주특별자치도 제주시 구좌읍 송당리 산 199-1,133,115,101,349,116
326,관광지,백년초농장박물관,제주특별자치도 서귀포시 태평로 200,125,112,112,349,116
211,관광지,돔베낭골,제주특별자치도 서귀포시 호근동,125,111,113,349,116
3804,음식점,허니문하우스,제주특별자치도 서귀포시 칠십리로 228-13,158,100,90,348,116
951,관광지,천주교 순례길 - 김기량길,제주특별자치도 제주시 조천읍 조천2길 19,123,118,108,349,116
511,관광지,솔담한방병원,제주특별자치도 제주시 1100로 3055,172,88,88,348,116
136,관광지,낙천아홉굿마을 의자공원,제주특별자치도 제주시 한경면 낙수로 97,133,109,105,347,116
295,관광지,문화예술마을 저지리 농어촌체험마을,제주시 한경면 중산간서로 3675,150,98,101,349,116
284,관광지,무수천,제주특별자치도 제주시 애월읍 무수천길,98,110,141,349,116
903,관광지,조천만세동산,제주특별자치도 제주시 조천읍 조천리 1133-2,120,101,126,347,116
614,관광지,어리목계곡,제주특별자치도 제주시 1100로 2070-61,138,91,115,344,115
2749,음식점,바다풍경횟집,제주특별자치도 제주시 서해안로 654,132,104,108,344,115
945,관광지,창고천생태공원,제주특별자치도 서귀포시 안덕면 일주서로 1524,118,112,114,344,115
2088,숙박,플레이스 캠프 제주,제주특별자치도 서귀포시 성산읍 동류암로 20,124,118,102,344,115
2289,음식점,국수바다 본점,제주특별자치도 서귀포시 일주서로 982,117,119,109,345,115
196,관광지,덕천리 팔자 좋아 길,제주특별자치도 제주시 구좌읍 중산간동로,115,126,105,346,115
967,관광지,추사적거지,제주특별자치도 서귀포시 대정읍 추사로 44,137,112,96,345,115
2271,음식점,곰막,제주특별자치도 제주시 구좌읍 구좌해안로 64,132,122,90,344,115
1403,숙박,더포그레이스호텔앤리조트,제주특별자치도 서귀포시 성산읍 해맞이해안로 2670,112,123,109,344,115
840,관광지,제주올레 15-A코스,제주특별자치도 제주시 애월읍 납읍리 2695-5,140,111,94,345,115
226,관광지,두산봉(말미오름),제주특별자치도 서귀포시 성산읍 시흥리 산 1-5,138,120,86,344,115
134,관광지,낙선동 4.3성,제주특별자치도 제주시 조천읍 선흘서5길 13,129,116,99,344,115
1265,숙박,가파도민박,제주특별자치도 서귀포시 대정읍 가파로67번길 5,124,125,95,344,115
1040,관광지,한국건강관리협회제주특별자치도부,제주특별자치도 제주시 연북로 111,83,117,142,342,114
844,관광지,제주올레 18-1코스,제주특별자치도 제주시 추자면 묵리 산 133,123,119,101,343,114
473,관광지,성널오름 (성판악),제주특별자치도 서귀포시 남원읍 신례리,121,103,119,343,114
128,관광지,김한미술관 & 카페3206,제주특별자치도 제주시 한림읍 한상로 115,113,106,124,343,114
24,관광지,간세공방,제주특별자치도 서귀포시 중정로 22,109,102,132,343,114
639,관광지,예래해안도로,제주특별자치도 서귀포시 예래해안로,115,104,121,340,113
2191,숙박,히든스테이,제주특별자치도 서귀포시 성산읍 성산중앙로40번길 12,103,225,11,339,113
634,관광지,영모원,제주특별자치도 제주시 애월읍 하귀리 1130-1,112,129,99,340,113
3724,음식점,피어22,제주특별자치도 제주시 한림읍 금능7길 22,102,110,128,340,113
3839,음식점,황금어장(제주시),제주특별자치도 제주시 사장길 14,133,109,98,340,113
657,관광지,온평리 환해장성,제주특별자치도 서귀포시 성산읍 환해장성로 732,119,103,118,340,113
2808,음식점,보목해녀의집,제주특별자치도 서귀포시 보목포로 48 (보목동),84,89,166,339,113
560,관광지,신천리 벽화마을,제주특별자치도 서귀포시 성산읍 신천리,125,103,112,340,113
3456,음식점,"제주한잔, 세화","제주특별자치도 제주시 구좌읍 세평항로 44 (세화리) 제주한잔, 세화",84,79,177,340,113
1926,숙박,제주아이브리조트,제주특별자치도 서귀포시 산록남로 1966-34,127,110,99,336,112
925,관광지,중문색달해변(해산물),제주특별자치도 서귀포시 중문관광로72번길 114,112,106,119,337,112
186,관광지,대정향교,제주특별자치도 서귀포시 안덕면 향교로 165-17,115,119,101,335,112
1207,쇼핑,제주 중앙지하상가,제주특별자치도 제주시 중앙로 지하 60,111,114,112,337,112
941,관광지,차귀도요트,제주특별자치도 제주시 한경면 한경해안로 156 2층,89,134,110,333,111
3389,음식점,제스토리,제주특별자치도 서귀포시 막숙포로 60,91,119,122,332,111
90,관광지,귀빈사,제주특별자치도 제주시 구좌읍 비자림로 1456,115,108,111,334,111
2816,음식점,복자씨연탄구이,제주특별자치도 서귀포시 성산읍 해맞이해안로 2764,119,97,118,334,111
126,관광지,김영수도서관,제주특별자치도 제주시 중앙로8길 18,112,117,105,334,111
1036,관광지,하멜기념비,제주특별자치도 서귀포시 안덕면 사계리 112-3,109,114,109,332,111
458,관광지,서영아리오름 / 용와이오름,제주특별자치도 서귀포시 안덕면 상천리 산22,128,104,100,332,111
908,관광지,족은노꼬메오름,제주특별자치도 제주시 애월읍 유수암리,132,88,112,332,111
885,관광지,제주항일기념관,제주특별자치도 제주시 조천읍 신북로 303,105,118,111,334,111
814,관광지,제주성지,제주특별자치도 제주시 오현길 61,143,93,96,332,111
2468,음식점,도두해녀의집,제주특별자치도 제주시 도두항길 16,100,111,120,331,110
261,관광지,망장포,제주특별자치도 서귀포시 남원읍 하례망장포로 65-13,107,104,120,331,110
248,관광지,마라도등대,제주특별자치도 서귀포시 대정읍 가파리 642,122,111,97,330,110
2248,음식점,고가네,제주특별자치도 서귀포시 성산읍 성산중앙로19번길 14,154,110,67,331,110
283,관광지,무비랜드왁스뮤지엄,제주특별자치도 서귀포시 중문관광로 205,113,97,119,329,110
213,관광지,동거문이오름,제주특별자치도 제주시 구좌읍 종달리 산 70,151,105,74,330,110
322,관광지,방선문,제주특별자치도 제주시 종천길 39-1,102,106,122,330,110
41,관광지,거인의 정원,제주특별자치도 제주시 대원길 58,120,110,101,331,110
395,관광지,사진놀이터,제주특별자치도 제주시 애월읍 평화로 2835,110,106,113,329,110
27,관광지,감귤상웨빵 체험,제주특별자치도 서귀포시 남원읍 하례중앙로 95,108,125,97,330,110
3133,음식점,야원,제주특별자치도 제주시 조천읍 번영로 1218 (대흘리) 야원,330,0,0,330,110
1193,쇼핑,여름문구사,제주특별자치도 제주시 구좌읍 구좌로 77,114,109,107,330,110
3038,음식점,쉬림프박스,제주특별자치도 제주시 구좌읍 평대리 2033-7,91,114,122,327,109
3655,음식점,키친오즈,제주시 한림읍 협재로 208,110,161,56,327,109
189,관광지,대포포구,제주특별자치도 서귀포시 대포로,113,95,120,328,109
664,관광지,왈종미술관,제주특별자치도 서귀포시 칠십리로214번길 30,100,106,122,328,109
132,관광지,나바론절벽,제주특별자치도 제주시 추자면 영흥리 산 19,122,112,92,326,109
920,관광지,주정공장(동척회사) 옛터,제주특별자치도 제주시 임항로 111 (건입동)일대,100,126,102,328,109
927,관광지,중문승마공원,제주특별자치도 서귀포시 이어도로 244,117,97,112,326,109
387,관광지,사계항,제주특별자치도 서귀포시 안덕면 사계리,114,106,106,326,109
109,관광지,기독교순례길 2코스(순교의길),제주특별자치도 제주시 한림읍 협재8길 8,108,110,109,327,109
2356,음식점,남경미락,제주특별자치도 서귀포시 안덕면 사계남로 190-7,98,119,108,325,108
76,관광지,관음사 템플스테이,제주시 산록북로 660,118,97,108,323,108
1446,숙박,라마다 제주 함덕 호텔,제주특별자치도 제주시 조천읍 신북로 470,106,94,124,324,108
598,관광지,알오름(표선면),제주특별자치도 서귀포시 표선면 토산리 산 11,117,102,105,324,108
1378,숙박,달달하우스,제주특별자치도 제주시 한림읍 한림로 414-6,65,127,132,324,108
225,관광지,두맹이골목,제주특별자치도 제주시 동문로16길 17-4,115,92,116,323,108
1792,숙박,여울목게스트하우스(월정리),제주특별자치도 제주시 구좌읍 월정중길 51,94,118,112,324,108
530,관광지,수악 (물오름),제주특별자치도 서귀포시 남원읍 516로 1042,108,102,110,320,107
988,관광지,큰사슴이오름,제주특별자치도 서귀포시 표선면 중산간동로,160,104,58,322,107
1180,쇼핑,신세계사이먼 제주 프리미엄 전문점,"제주특별자치도 서귀포시 안덕면 신화역사로304번길 38 신세계사이먼 제주 프리미엄 전문점 G층, B1층",105,109,107,321,107
442,관광지,서귀포 다이브센터,제주특별자치도 서귀포시 남원읍 하례리 64-11,93,90,138,321,107
3707,음식점,평대성게국수,제주특별자치도 제주시 구좌읍 해맞이해안로 1172,112,83,126,321,107
3559,음식점,치치퐁,제주특별자치도 서귀포시 안덕면 사계남로216번길 24-62,112,113,96,321,107
244,관광지,마라도 섬투어,제주특별자치도 서귀포시 대정읍 마라로 65,131,96,95,322,107
52,관광지,고내리 다락쉼터,제주특별자치도 제주시 애월읍 애월해안로 284,134,88,100,322,107
654,관광지,오현단,제주특별자치도 제주시 오현길 61,125,94,103,322,107
585,관광지,아일랜드에프,"제주특별자치도 서귀포시 성산읍 성산등용로 112-7, 2층",118,99,104,321,107
985,관광지,큰넓궤,제주특별자치도 서귀포시 안덕면 동광리 90 일대,117,103,100,320,107
1107,관광지,휘닉스 르쏠레이테라피,제주특별자치도 서귀포시 성산읍 섭지코지로 107 휘닉스제주아일랜드리조트 블루동 1층,110,101,110,321,107
633,관광지,영등할망 신화공원,제주 제주시 한림읍 귀덕11길 19,134,100,84,318,106
546,관광지,신도포구,제주특별자치도 서귀포시 대정읍 신도리,116,113,88,317,106
243,관광지,롯데호텔 브이스파,"제주특별자치도 서귀포시 중문관광로72번길 35, lobby floor 8F",92,110,115,317,106
573,관광지,씨에스호텔 프라이빗스파,제주특별자치도 서귀포시 중문관광로 198,108,105,104,317,106
786,관광지,제주도공방노꼬메,제주특별자치도 제주시 동문로21길 19-2,118,87,114,319,106
1059,관광지,한모살 (표선백사장),제주특별자치도 제주시 표선면 표선리,131,100,88,319,106
831,관광지,제주오름승마랜드,조천읍 번영로 1734-15,119,105,92,316,105
1436,숙박,디아넥스 호텔,제주특별자치도 서귀포시 안덕면 산록남로762번길 71,92,109,114,315,105
36,관광지,갤러리2 중선농원,제주특별자치도 제주시 영평길 269,111,101,102,314,105
830,관광지,제주오렌지,제주특별자치도 서귀포시 남원읍 서성로 684-5,119,104,91,314,105
2127,숙박,해녀신춘자할망 민박,제주 서귀포시 성산읍 오조로92,127,85,103,315,105
2260,음식점,고서방해물탕,제주특별자치도 서귀포시 대정읍 형제해안로 282,107,107,100,314,105
1229,쇼핑,폴개협동조합,제주특별자치도 서귀포시 남원읍 원님서로326번길 38-51,105,96,113,314,105
2917,음식점,새빌,제주특별자치도 제주시 애월읍 평화로 1529,129,109,76,314,105
2023,숙박,클럽ES리조트 제주,제주특별자치도 서귀포시 1100로 501,107,108,100,315,105
2281,음식점,교래손칼국수,제주특별자치도 제주시 조천읍 비자림로 645,96,98,120,314,105
1128,쇼핑,대정오일시장,제주특별자치도 서귀포시 대정읍 신영로36번길 65,103,101,109,313,104
540,관광지,스위트호텔 아로마,제주특별자치도 서귀포시 중문관광로72번길 67,107,107,97,311,104
1072,관광지,해빛,제주특별자치도 제주시 조천읍 신촌9길 8,179,72,60,311,104
741,관광지,자리왓,제주특별자치도 제주시 애월읍 봉성리 1410 일대,134,100,79,313,104
2904,음식점,삼대국수회관,제주특별자치도 제주시 삼성로 41,122,97,92,311,104
417,관광지,삼양 셋다리물,제주특별자치도 제주시 삼양1동 1938-9,88,93,132,313,104
1020,관광지,포토갤러리 자연사랑미술관,제주특별자치도 서귀포시 표선면 가시리 1920-1,118,112,83,313,104
131,관광지,꿈바당 어린이도서관,제주특별자치도 제주시 연오로 140,102,99,112,313,104
3394,음식점,제주 어가,제주특별자치도 제주시 1100로 3213-8,105,123,83,311,104
81,관광지,구엄포구,제주특별자치도 제주시 애월읍 구엄리,119,87,106,312,104
955,관광지,천주교길 정난주길(고통의길),제주특별자치도 서귀포시 대정읍 추사로247번길 102,131,100,81,312,104
964,관광지,추사 유배길 - 1코스 집념의 길,제주특별자치도 서귀포시 대정읍 추사로 44,116,106,86,308,103
701,관광지,월라봉 진지동굴 (안덕면),제주 서귀포시 안덕면 감산리,109,101,98,308,103
3683,음식점,토끼와거북이,"제주특별자치도 제주시 서해안로 498-6, 101호",94,116,100,310,103
2889,음식점,산도롱맨도롱,제주특별자치도 제주시 구좌읍 해맞이해안로 2284,105,93,110,308,103
66,관광지,공천포,제주특별자치도 서귀포시 남원읍 신례리,78,102,129,309,103
2955,음식점,섭지해녀의집,제주특별자치도 서귀포시 성산읍 섭지코지로 95,90,99,119,308,103
349,관광지,보물섬하이킹,제주특별자치도 제주시 용문로14길 14,101,99,108,308,103
950,관광지,천제연폭포 & 제주4.3중문면희생자위령비,제주특별자치도 서귀포시 천제연로 132,96,115,98,309,103
368,관광지,붉은오름(성산읍),제주특별자치도 서귀포시 성산읍 섭지코지로 261,136,94,78,308,103
883,관광지,제주한라병원,제주특별자치도 제주시 도령로 65,106,92,111,309,103
2949,음식점,섬소나이,제주특별자치도 제주시 우도면 우도해안길 814,102,105,98,305,102
182,관광지,대유ATV수렵사격랜드,제주특별자치도 서귀포시 상예로 381,112,92,101,305,102
913,관광지,종달고망난돌쉼터,제주 제주시 구좌읍 종달리 112-4,111,85,110,306,102
1041,관광지,한국병원,제주특별자치도 제주시 서광로 193,114,114,77,305,102
3232,음식점,올레수산회센터,제주도 서귀포시 중정로 61번길 12,105,96,104,305,102
628,관광지,연미마을(오라리 방화사건 현장),제주특별자치도,122,89,94,305,102
590,관광지,아홉굿마을 낙천리 농어촌체험마을,한경면 낙수로 97,109,100,98,307,102
1053,관광지,한라승마장,제주특별자치도 서귀포시 안덕면 평화로 1078,115,85,105,305,102
2308,음식점,그리운바다성산포,제주특별자치도 서귀포시 성산읍 성산등용로 94,107,93,105,305,102
105,관광지,금붕사,제주특별자치도 제주시 구좌읍 일주동로 3618-1,117,96,92,305,102
3414,음식점,제주미향,제주특별자치도 서귀포시 천제연로 99,102,106,99,307,102
360,관광지,북촌국민학교,제주특별자치도 제주시 조천읍 일주동로 1481,106,105,93,304,101
1532,숙박,민박바당집,제주특별자치도 제주시 한림읍 협재1길 12,122,88,94,304,101
572,관광지,썬플라워의원,제주특별자치도 제주시 한림읍 금능남로 127,115,92,97,304,101
3754,음식점,한라산빵 1950,제주특별자치도 제주시 구산로 28,129,84,90,303,101
242,관광지,로로 요가,제주특별자치도 제주시 조천읍 조함해안로 519-10,86,107,111,304,101
705,관광지,월령포구,제주특별자치도 제주시 한림읍 월평리,97,93,112,302,101
721,관광지,이랜드뮤지엄,제주특별자치도 제주시 한림해안로 530,86,115,101,302,101
1996,숙박,추자도민박,제주특별자치도 제주시 추자면 묵리2길 37-7,112,93,99,304,101
1013,관광지,평대리불턱,제주특별자치도 제주시 구좌읍 해맞이해안로 1240-3,100,103,99,302,101
930,관광지,중앙병원,제주특별자치도 제주시 월랑로 91,99,98,105,302,101
3590,음식점,카페마니,제주특별자치도 제주시 구좌읍 해맞이해안로 1112,71,150,83,304,101
16,관광지,가메오름,제주특별자치도 제주시 애월읍 봉성리 산 125,119,94,90,303,101
159,관광지,누운오름(한림읍),제주특별자치도 제주시 한림읍 금악리 188-2,131,86,86,303,101
558,관광지,신창리포구,제주특별자치도 제주시 한경면 신창리,98,109,93,300,100
3438,음식점,제주와인창고,제주특별자치도 제주시 연북로 424,101,108,91,300,100
3783,음식점,해녀세자매,제주특별자치도 제주시 한림읍 한림로3길 10-11,109,109,82,300,100
3858,음식점,흑한우명품관,제주특별자치도 서귀포시 일주동로 8421,89,109,102,300,100
1201,쇼핑,이제주숍,제주특별자치도 제주시 연삼로 473,102,94,105,301,100
901,관광지,조이다이브,서귀포시 중산간동로 83838,90,106,105,301,100
29,관광지,갑자기 히어로즈 벽화길,제주특별자치도 제주시 애월읍 금성1길 29-3,112,99,89,300,100
474,관광지,성불오름,제주 제주시 구좌읍 중산간동로 2532,140,80,79,299,100
1078,관광지,허브동산 미디어 파사드 (media facade),제주특별자치도 서귀포시 표선면 돈오름로 170,96,110,95,301,100
1609,숙박,블루하와이리조트,제주특별자치도 제주시 한림읍 한림로 77,109,96,95,300,100
163,관광지,다끄네포구(용담포구),제주특별자치도 제주시 용담3동,78,83,138,299,100
262,관광지,매오름,제주특별자치도 서귀포시 표선면 표선리 산 2,132,83,82,297,99
142,관광지,남원 위미2리 어촌계,제주특별자치도 서귀포시 남원읍 태위로 208,117,90,90,297,99
363,관광지,북촌포구,제주특별자치도 제주시 조천읍 북촌9길 26-1,104,108,85,297,99
2809,음식점,보스코화덕피자,제주특별자치도 제주시 수목원길 27,126,81,90,297,99
161,관광지,눈물의십자가,제주특별자치도 제주시 추자도,103,98,96,297,99
758,관광지,제로스테이션(제로포인트트레일),제주특별자치도 제주시 산지로 25 2층,102,99,96,297,99
1963,숙박,제주해나루,제주특별자치도 서귀포시 신서로98번길 19-1 (강정동) 제주해나루,101,113,83,297,99
897,관광지,조선한의원,제주특별자치도 제주시 진군남4길 7-1,97,96,103,296,99
3037,음식점,쉬는팡가든,제주특별자치도 서귀포시 상예로 248,64,77,156,297,99
1164,쇼핑,샘스제주캔들,제주특별자치도 제주시 애월읍 애월로1길 26-2,82,90,126,298,99
2762,음식점,바보카페,제주특별자치도 제주시 구좌읍 해맞이해안로 1016,70,141,85,296,99
3136,음식점,양가형제,제주특별자치도 제주시 한경면 청수동8길 3,98,93,103,294,98
290,관광지,문서프,제주특별자치도 제주시 애월읍 곽지7길 1,103,91,101,295,98
411,관광지,삼각봉,제주특별자치도 제주시 1100로 2070-61,81,110,102,293,98
118,관광지,김녕항,제주특별자치도 제주시 구좌읍 김녕항1길 50-13,93,103,99,295,98
2114,숙박,하워드존슨 제주 연동 호텔,제주특별자치도 제주시 삼무로 57,90,100,105,295,98
2701,음식점,문동일셰프녹차고을,제주특별자치도 제주시 애월읍 하귀동남4길 13-1,98,100,97,295,98
229,관광지,들렁모루 산책길,제주특별자치도 서귀포시 서홍동 2437,124,96,74,294,98
67,관광지,공천포구,제주특별자치도 서귀포시 남원읍 신례리,98,89,106,293,98
31,관광지,강병대교회,제주특별자치도 서귀포시 대정읍 상모대서로 43-3,94,93,107,294,98
3460,음식점,젠하이드어웨이,제주특별자치도 서귀포시 안덕면 사계남로 186-8,123,107,64,294,98
1023,관광지,푸른콩 방주영농조합법인,제주특별자치도 서귀포시 중산간서로 740(중문동),92,101,102,295,98
486,관광지,성읍승마장,제주특별자치도 서귀포시 표선면 번영로 2650,104,103,86,293,98
1024,관광지,풋감마을 소길리 농어촌체험마을,제주시 애월읍 소길1길 15,93,99,101,293,98
817,관광지,제주스쿠터여행,제주시 서광로 164,101,98,94,293,98
679,관광지,우도 득성이코지,제주특별자치도 제주시 우도면 연평리,106,81,104,291,97
3540,음식점,청파식당횟집,제주특별자치도 제주시 구좌읍 세평항로 12,119,95,77,291,97
195,관광지,더힐하우스스파,제주특별자치도 제주시 한림읍 한창로 925-122,102,90,100,292,97
2879,음식점,사계바다,제주특별자치도 서귀포시 안덕면 형제해안로 26,119,93,79,291,97
911,관광지,존자암지,제주특별자치도 서귀포시 영실로 243,113,88,91,292,97
863,관광지,제주인디,제주특별자치도 서귀포시 성산읍 중산간동로 4150-30,108,99,84,291,97
498,관광지,세화항,제주특별자치도 제주시 구좌읍 세화리,105,100,86,291,97
954,관광지,천주교 순례길 - 하논성당길,제주특별자치도 서귀포시 태평로 398,111,89,92,292,97
3448,음식점,제주침시술소바 (오로라식품),제주특별자치도 제주시 동광로 12,86,98,105,289,96
320,관광지,밧돌오름,제주특별자치도 제주시 구좌읍 송당리 산 66-1,109,96,83,288,96
46,관광지,걸매예술마을,제주특별자치도 서귀포시 서홍로 4-42,112,83,94,289,96
1295,숙박,그랜드 조선 제주,제주특별자치도 서귀포시 중문관광로72번길 60,84,95,109,288,96
383,관광지,빠우사,제주특별자치도 제주시 조천읍 선교로 539,94,105,89,288,96
2965,음식점,성산일출봉 해송갈치전문점,제주특별자치도 서귀포시 성산읍 일출로 270-2,108,102,79,289,96
2723,음식점,미영이네식당,제주 서귀포시 대정읍 하모항구로 42,100,90,98,288,96
722,관광지,이로이로공방,제주특별자치도 제주시 구좌읍 하도7길 16-11,96,97,94,287,96
1997,숙박,추자도휴양펜션,제주특별자치도 제주시 추자면 석두리길 4,77,115,96,288,96
3288,음식점,원앤온리,제주특별자치도 서귀포시 안덕면 산방로 141,112,99,78,289,96
54,관광지,"고내봉(고내오름,고니오름,망오름)",제주특별자치도 제주시 애월읍 고내리 산 3-1,111,90,87,288,96
2406,음식점,다육이풍경,제주특별자치도 서귀포시 하효중앙로98번길 27,82,101,105,288,96
931,관광지,중엄리새물,제주특별자치도 제주시 애월읍 애월해안로 10-2,119,81,89,289,96
124,관광지,김서프제주,제주특별자치도 서귀포시 색달로81번길 39,94,89,103,286,95
2766,음식점,바움하우스,제주특별자치도 제주시 서해안로 448,70,206,9,285,95
3486,음식점,중앙식당,제주특별자치도 서귀포시 안덕면 화순로 108,94,80,111,285,95
413,관광지,삼매봉,제주특별자치도 서귀포시 남성로115번길 83,102,96,87,285,95
2970,음식점,성산흑돼지두루치기,제주특별자치도 서귀포시 성산읍 한도로 255,139,79,68,286,95
53,관광지,고내리포구,제주특별자치도 제주시 애월읍 고내리,107,84,94,285,95
1213,쇼핑,제주보성시장,제주특별자치도 제주시 동광로1길 32,96,100,89,285,95
890,관광지,제주향교,제주특별자치도 제주시 서문로 43,102,99,84,285,95
680,관광지,우도 봉수대,제주특별자치도 제주시 우도면 연평리 798,103,86,94,283,94
1986,숙박,청재설헌,제주특별자치도 서귀포시 인정오름로 135-18,118,82,82,282,94
539,관광지,스위트몽키,제주특별자치도 제주시 한경면 산양6길 6-9,89,92,101,282,94
1809,숙박,오션스위츠호텔 제주,제주특별자치도 제주시 탑동해안로 74,91,83,108,282,94
334,관광지,법정사,제주특별자치도 서귀포시 1100로 740-168,101,92,90,283,94
2388,음식점,늘봄흑돼지,제주특별자치도 제주시 한라대학로 12,107,91,83,281,94
569,관광지,심헌갤러리,제주특별자치도 제주시 아란14길 3,99,103,79,281,94
996,관광지,터진목 & 성산면 4·3희생자 위령비,제주특별자치도 서귀포시 성산읍 일출로 88-19,104,96,81,281,94
1646,숙박,서머셋 제주신화월드 호텔앤리조트,제주특별자치도 서귀포시 안덕면 신화역사로304번길 89,90,94,98,282,94
2969,음식점,성산회관,제주특별자치도 서귀포시 성산읍 성산중앙로 8,90,80,111,281,94
2512,음식점,동해미락,제주특별자치도 서귀포시 칠십리로 133,111,97,75,283,94
141,관광지,남수각 하늘길 벽화거리,제주특별자치도 제주시 중앙로13길 32,113,95,74,282,94
2598,음식점,마로니에 미니골프카페,제주특별자치도 서귀포시 남원읍 신례천로 158-8,105,94,83,282,94
1089,관광지,형제해안로전망대,제주특별자치도 서귀포시 안덕면 형제해안로 26,112,75,94,281,94
42,관광지,거친오름,제주특별자치도 제주시 명림로 520 (봉개동),93,85,104,282,94
1287,숙박,골든튤립 제주 성산호텔,제주특별자치도 서귀포시 성산읍 일출로 31,87,99,93,279,93
223,관광지,동일리포구,제주특별자치도 서귀포시 대정읍 동일리,79,95,105,279,93
1215,쇼핑,제주시농협농산물직거래센터,제주특별자치도 제주시 남광로 206,86,96,97,279,93
22,관광지,가파초등학교 마라분교장,제주특별자치도 서귀포시 대정읍 마라로 58,95,111,74,280,93
357,관광지,부영컨트리클럽,제주특별자치도 서귀포시 남원읍 남조로 960 부영CC,101,81,96,278,93
837,관광지,제주올레 13코스,제주특별자치도 제주시 한경면 조수리 2137-2,98,111,69,278,93
784,관광지,제주대학교 가는길,제주특별자치도 제주시 제주대학로 102,101,98,81,280,93
1764,숙박,야호비치하우스,제주특별자치도 제주시 조천읍 조함해안로 582,82,95,101,278,93
806,관광지,제주불교성지 순례길 절로 가는길 - 보시의 길,제주특별자치도 제주시 애월읍 수산곰솔길 56,79,123,76,278,93
807,관광지,제주불교성지 순례길 절로 가는길 - 인욕의 길,제주특별자치도 제주시 산록북로 660,107,81,91,279,93
2456,음식점,덤장,제주특별자치도 제주시 용문로 48,73,116,91,280,93
2640,음식점,맥파이 브루어리,제주특별자치도 제주시 동회천1길 23,86,96,96,278,93
1032,관광지,하논마르,제주특별자치도 서귀포시 서홍동 1003,90,102,88,280,93
2613,음식점,만덕이네,제주특별자치도 서귀포시 표선면 서성일로 16,94,84,101,279,93
2795,음식점,벵디,제주특별자치도 제주시 구좌읍 해맞이해안로 1108,79,94,105,278,93
86,관광지,굴동포구,제주특별자치도 제주시 구좌읍 해맞이해안로,97,87,96,280,93
176,관광지,당오름(한경면),제주특별자치도 제주시 한경면 용수리 산 18,89,99,88,276,92
366,관광지,불탑사 (5층석탑),제주특별자치도 제주시 원당로16길 41,109,89,77,275,92
370,관광지,브레이브독스,제주특별자치도 제주시 한림읍 한수풀로 138,94,74,108,276,92
754,관광지,정의향교,제주특별자치도 서귀포시 표선면 성읍서문로 14,93,85,97,275,92
1306,숙박,글라라의집,제주특별자치도 서귀포시 안덕면 사계남로 211,91,118,67,276,92
1742,숙박,아이비테라스,제주특별자치도 서귀포시 법환상로 65,87,101,89,277,92
496,관광지,세인트포골프장,제주특별자치도 제주시 구좌읍 선유로 445-55,92,85,99,276,92
561,관광지,신천리(용궁올레),제주특별자치도 서귀포시 표선면 신천리,101,91,84,276,92
2390,음식점,늘푸른농원 연리지가든,제주특별자치도 제주시 한경면 두조로 190-20,101,92,82,275,92
3794,음식점,해월정,제주특별자치도 제주시 구좌읍 해맞이해안로 2340,95,91,91,277,92
98,관광지,그제바람 윈드서핑패들보드,제주특별자치도 제주시 선사로8길 13-4,78,103,96,277,92
1509,숙박,메종글래드 제주,제주특별자치도 제주시 노연로 80,86,92,98,276,92
702,관광지,월라봉(효돈),제주특별자치도 서귀포시 월라봉로,94,95,87,276,92
3190,음식점,옛날동문시장칼국수,제주특별자치도 제주시 동문로4길 9,103,91,81,275,92
500,관광지,세화해안도로,제주특별자치도 제주시 구좌읍 구좌로,86,91,95,272,91
631,관광지,열리해안길,제주특별자치도 서귀포시 하예동,109,76,89,274,91
3727,음식점,피제리아3657,제주특별자치도 서귀포시 안덕면 난드르로 56,116,90,67,273,91
601,관광지,알진오름(안친오름),제주특별자치도 제주시 구좌읍 송당리 880-1,110,90,72,272,91
59,관광지,고요산책,제주특별자치도 제주시 중앙로12길 5,99,95,79,273,91
95,관광지,그랑블루호(선상낚시),제주특별자치도 서귀포시 남원읍 위미중앙로180번길 10,102,75,95,272,91
1252,숙박,Oh! 세화! (오세화게스트하우스),제주특별자치도 제주시 구좌읍 세송로 8-11,74,101,99,274,91
1655,숙박,세화맨션,제주특별자치도 제주시 구좌읍 세화7길 17-10,63,89,121,273,91
2180,숙박,홍익샤모니리조트,제주특별자치도 서귀포시 중산간서로 68,87,100,85,272,91
1970,숙박,조천스테이,제주특별자치도 제주시 조천읍 조천9길 30-1,96,104,74,274,91
3105,음식점,안거리밖거리,제주특별자치도 서귀포시 솔동산로 6-1,83,99,90,272,91
1025,관광지,프랑스샤르망,제주시 한림읍 명상로 37,95,85,93,273,91
898,관광지,조수리 농어촌체험마을,제주특별자치도 제주시 한경면 조수리,91,95,86,272,91
720,관광지,이덕구 산전,제주특별자치도 제주시 조천읍 516로 1865,94,88,89,271,90
2272,음식점,곱들락,제주특별자치도 제주시 조천읍 함덕18길 19,83,93,95,271,90
3174,음식점,연동마라도횟집,제주특별자치도 제주시 신광로8길 3,104,82,84,270,90
520,관광지,송악카트체험장,제주특별자치도 서귀포시 대정읍 송악관광로 404,92,86,92,270,90
3203,음식점,오라숲소리,제주특별자치도 제주시 오라로 80,95,82,92,269,90
715,관광지,유리멘탈 스튜디오,제주특별자치도 제주시 한경면 낙수로12길,104,82,84,270,90
447,관광지,서귀포의료원,제주특별자치도 서귀포시 장수로 47,96,92,81,269,90
2147,숙박,해일월,제주특별자치도 제주시 구좌읍 김녕항3길 26-29,111,103,57,271,90
1838,숙박,월정에비뉴,제주특별자치도 제주시 구좌읍 해맞이해안로 486,63,86,120,269,90
278,관광지,무등이왓터,제주특별자치도 서귀포시 안덕면 신화역사로586번길 21-7,98,94,78,270,90
963,관광지,최영장군사당,제주특별자치도 제주시 추자면 대서3길 10,81,99,90,270,90
2931,음식점,서귀피안베이커리,제주특별자치도 서귀포시 성산읍 신양로122번길 17,109,71,90,270,90
2125,숙박,함덕삼다펜션,제주특별자치도 제주시 조천읍 조함해안로 488,84,85,101,270,90
221,관광지,동산농원 딸기체험장,제주특별자치도 제주시 한경면 저지리 1448-2,92,83,92,267,89
775,관광지,제주국제평화센터,제주특별자치도 서귀포시 중문 관광로 227-24,89,89,89,267,89
3010,음식점,수복강녕,제주특별자치도 제주시 선덕로3길 40,105,89,74,268,89
3309,음식점,유동커피,제주특별자치도 서귀포시 태평로 406-2,89,92,85,266,89
748,관광지,절물오름(큰대나),제주특별자치도 제주시 명림로 584 일대,127,63,76,266,89
662,관광지,옹포포구,제주특별자치도 제주시 한림읍 옹포리,77,95,94,266,89
1130,쇼핑,더아일랜더,제주특별자치도 제주시 중앙로7길 31 102호,68,83,115,266,89
1317,숙박,꽃하루방게스트하우스,제주특별자치도 서귀포시 성산읍 온평포구로62번길 24,86,98,82,266,89
65,관광지,공방:하루_반,제주특별자치도 제주시 구좌읍 월정7길 42-6 1층,82,98,86,266,89
3613,음식점,카페콜라,제주특별자치도 제주시 한림읍 일주서로 5857,77,126,63,266,89
1272,숙박,객의하우스,제주특별자치도 제주시 한림읍 한림로 381-3,80,87,101,268,89
1039,관광지,하예포구(예래포구),제주특별자치도 서귀포시 하예동,92,89,85,266,89
1704,숙박,신라스테이 제주,제주특별자치도 제주시 노연로 100,89,90,87,266,89
2545,음식점,랜딩 다이닝(Landing dining),제주특별자치도 서귀포시 안덕면 신화역사로304번길 38 랜딩관 제주신화월드 호텔앤리조트 G층,75,88,103,266,89
966,관광지,추사 유배길 - 3코스 사색의 길,제주특별자치도 서귀포시 안덕면 향교로 165-17,87,96,84,267,89
269,관광지,모구리오름,제주특별자치도 서귀포시 성산읍 서성일로 260,99,88,80,267,89
3188,음식점,옐로우카페 (yellow cafe),제주 서귀포시 중문관광로 90,97,79,92,268,89
2906,음식점,삼대해녀의집,제주특별자치도 서귀포시 성산읍 환해장성로 583-5,128,85,53,266,89
2740,음식점,바다를 본 돼지(서귀포점),제주특별자치도 서귀포시 칠십리로 123,110,77,81,268,89
129,관광지,까끄래기오름,제주시 조천읍 교래리 128,121,84,62,267,89
469,관광지,섬속의섬우도렌트,제주특별자치도 제주시 우도면 우도해안길 84-2,89,75,104,268,89
725,관광지,이음새,제주특별자치도 서귀포시 남원읍 위미리 4137-1,107,85,76,268,89
3220,음식점,옥돔식당,제주특별자치도 서귀포시 대정읍 신영로36번길 62,105,87,74,266,89
355,관광지,봉쥬르봉봉,제주특별자치도 제주시 한림읍 한림로 408-2,86,80,99,265,88
3076,음식점,신화테라스,제주특별자치도 서귀포시 안덕면 신화역사로304번길 98,78,79,108,265,88
881,관광지,제주플래티늄카라반,제주시 애월읍 하귀미수포길 5-8,93,80,92,265,88
1948,숙박,제주통나무휴양펜션,제주특별자치도 서귀포시 표선면 번영로 3328,73,91,100,264,88
224,관광지,돛오름,제주특별자치도 제주시 구좌읍 송당리 산 3,94,91,80,265,88
28,관광지,감수굴 밭담길,제주특별자치도 제주시 구좌읍 평대7길 34,107,81,75,263,88
3475,음식점,중문덤장,제주특별자치도 서귀포시 천제연로 17,100,86,77,263,88
773,관광지,제주국제예술센터,제주특별자치도 서귀포시 대정읍 서삼중로 117,104,85,76,265,88
3433,음식점,제주오성,제주특별자치도 서귀포시 중문관광로 27,110,84,69,263,88
1927,숙박,제주애단비,제주특별자치도 제주시 한경면 산양4길 27-2,84,83,97,264,88
26,관광지,감귤박물관 월라봉 산책로 - 생이소리길,제주특별자치도 서귀포시 효돈순환로 441,90,96,78,264,88
2927,음식점,서귀포갈비,제주특별자치도 서귀포시 동홍로 42,122,69,74,265,88
110,관광지,기독교순례길 3코스(사명의길),제주특별자치도 제주시 한경면 조수3길 7,90,86,87,263,88
306,관광지,민오름(봉개동),제주특별자치도 제주시 칠오름길 (봉개동),102,84,76,262,87
873,관광지,제주카약,제주특별자치도 제주시 조천읍 평사길 19,71,78,112,261,87
14,관광지,가마오름,제주특별자치도 제주시 한경면 청수서5길 63,107,81,72,260,87
2673,음식점,모루쿠다,제주특별자치도 서귀포시 동홍중앙로90번길 48,92,85,83,260,87
2886,음식점,사형제횟집,제주특별자치도 제주시 한림읍 한림상로 273,75,103,84,262,87
749,관광지,절부암,제주특별자치도 제주시 한경면 용수3길 22,79,82,101,262,87
2079,숙박,폴에이리조트,제주특별자치도 서귀포시 월드컵로45번길 40,108,90,64,262,87
2903,음식점,삼다정,제주특별자치도 제주시 노연로 80,74,87,100,261,87
1029,관광지,피크닉메이트,제주특별자치도 제주시 아란4길 84,90,89,81,260,87
3490,음식점,지미스,제주특별자치도 제주시 우도면 우도해안길 1132,59,134,67,260,87
609,관광지,애월환해장성,제주특별자치도 제주시 애월읍 애월로3길 60,93,71,98,262,87
912,관광지,종남마을,제주특별자치도,89,97,75,261,87
797,관광지,제주롯데스카이힐컨트리클럽,제주특별자치도 서귀포시 상예로 530,91,98,72,261,87
2435,음식점,대우정,제주특별자치도 서귀포시 이어도로 866-37,82,83,96,261,87
167,관광지,다려도,제주특별자치도 제주시 조천읍 북촌리,95,83,84,262,87
1401,숙박,더큐브리조트 제주,제주특별자치도 서귀포시 솔오름로105번길 24,98,82,81,261,87
669,관광지,용담 1동 벽화거리,제주특별자치도 제주시 서문로5길 1,90,81,90,261,87
172,관광지,답다니 탑망대 (하트원담),제주특별자치도 제주시 우도면 연평리 798,87,82,89,258,86
2473,음식점,독개물항,제주특별자치도 제주시 한림읍 한림로 478,86,94,79,259,86
275,관광지,목시물굴,제주특별자치도 제주시 조천읍 선흘리 산26번지 일대,91,87,81,259,86
838,관광지,제주올레 14-1코스,제주특별자치도 서귀포시 안덕면 서광리 산 50-22,97,84,76,257,86
2202,음식점,24시전주명가콩나물국밥,제주특별자치도 제주시 구산로 59,107,68,84,259,86
1568,숙박,밸류호텔 월드와이드 제주,제주특별자치도 제주시 삼무로 56,105,75,77,257,86
2467,음식점,도두반점,제주특별자치도 제주시 서해안로 291-5,82,73,103,258,86
902,관광지,조일구락부 옛터,제주특별자치도 제주시 관덕로2길 11,77,109,72,258,86
1972,숙박,중문그린힐통나무펜션,제주특별자치도 서귀포시 천제연로 103-36,70,83,104,257,86
3102,음식점,아줄레주,제주특별자치도 서귀포시 성산읍 신풍하동로19번길 59,111,72,74,257,86
3282,음식점,울트라마린,제주특별자치도 제주시 한경면 일주서로 4611,121,71,66,258,86
1077,관광지,행원육상양식단지,제주특별자치도 제주시 구좌읍 해맞이해안로 680-13,84,84,89,257,86
111,관광지,기독교순례길 4코스(화해의길),제주특별자치도 서귀포시 대정읍 추사로36번길 11,92,82,84,258,86
3700,음식점,팔도수산식당,제주특별자치도 제주시 임항로 27,109,83,67,259,86
3080,음식점,쌍둥이횟집본점,제주특별자치도 서귀포시 중정로62번길 14,97,92,70,259,86
1003,관광지,토종닭유통특구교래삼다수마을,제주특별자치도 제주시 조천읍 교래리,98,85,76,259,86
2010,숙박,켄싱턴리조트 제주 한림점,제주특별자치도 제주시 한림읍 한림해안로 530,84,77,96,257,86
441,관광지,서귀포 궁도장(천지정),제주특별자치도 서귀포시 중산간서로 97-40,97,71,89,257,86
3362,음식점,자매국수 본점,제주특별자치도 제주시 탑동로11길 6,128,70,60,258,86
1096,관광지,화순리 유채꽃길,제주특별자치도 서귀포시 안덕면 화순리 1230-4,121,71,67,259,86
1599,숙박,블라제리조트,제주특별자치도 서귀포시 표선면 녹산로 274,71,136,52,259,86
484,관광지,성읍목장,제주특별자치도 서귀포시 표선면 성읍리 1734,89,84,84,257,86
1779,숙박,에코하우스민박펜션,제주특별자치도 제주시 추자면 추자로 657,86,88,84,258,86
3633,음식점,커피템플,제주특별자치도 제주시 영평길 269 1층,89,91,78,258,86
2896,음식점,산포식당,제주특별자치도 서귀포시 성산읍 서성일로 1134,64,91,101,256,85
1054,관광지,한라의향기,제주특별자치도 서귀포시 안덕면 병악로 58,102,93,61,256,85
406,관광지,산지천갤러리,제주특별자치도 제주시 중앙로3길 36,92,68,96,256,85
2806,음식점,보말보말,제주특별자치도 제주시 애월읍 애월로 57,98,82,76,256,85
83,관광지,구좌해안로,제주특별자치도 제주시 구좌읍 구좌해안로,105,74,76,255,85
376,관광지,비양도의 비양나무자생지,제주특별자치도 제주시 한림읍 협재리 산 89,89,79,87,255,85
1906,숙박,제주바다펜션,제주특별자치도 제주시 구좌읍 해맞이해안로 2324,71,107,76,254,85
3121,음식점,앞뱅디식당,제주특별자치도 제주시 선덕로 32,102,77,76,255,85
691,관광지,우포토 시네마 갤러리 카페,제주특별자치도 서귀포시 대정읍 상모로 216-2,86,90,80,256,85
1755,숙박,안녕김녕sea,제주특별자치도 제주시 구좌읍 구좌해안로 178,80,90,84,254,85
596,관광지,"알밤(알바매기, 알밤오름)",제주특별자치도 제주시 조천읍 선흘남4길 229,95,87,72,254,85
3457,음식점,제주한치빵 우도점,제주특별자치도 제주시 우도면 우도해안길 802 (연평리) 제주한치빵 우도점,81,77,97,255,85
240,관광지,렛츠런팜 양귀비꽃,제주특별자치도 제주시 조천읍 남조로 1660,94,80,77,251,84
127,관광지,김택화미술관,제주특별자치도 제주시 조천읍 신흥로 1,93,87,71,251,84
37,관광지,거린오름 (북오름),제주특별자치도 서귀포시 안덕면 동광리 산 94,92,86,73,251,84
385,관광지,쁘램 요가,제주특별자치도 제주시 연북로 88,91,82,79,252,84
1969,숙박,조천댁,제주특별자치도 제주시 조천읍 조천7길 19-17,81,83,87,251,84
1008,관광지,파군봉(바굼지오름),제주특별자치도 제주시 애월읍 상귀서길 95,92,87,72,251,84
2288,음식점,국수마당,제주특별자치도 제주시 삼성로 65,81,90,81,252,84
3558,음식점,치저스,제주특별자치도 제주시 구좌읍 비자림로 1785,93,74,85,252,84
3229,음식점,올레7돈 (올레칠돈),제주특별자치도 서귀포시 월평하원로 20,86,81,86,253,84
494,관광지,세미오름(삼의양오름),제주특별자치도 제주시 아라동 산 24-2,99,78,75,252,84
1143,쇼핑,만춘서점,제주특별자치도 제주시 조천읍 함덕로 9,84,82,86,252,84
678,관광지,용연카누클럽,제주특별자치도 제주시 용담2동 438,68,85,99,252,84
1075,관광지,해피맘하우스,제주특별자치도 제주시 애월읍 애월해안로 306-3,86,90,77,253,84
1761,숙박,애월포구풍경,제주특별자치도 제주시 애월읍 애월로11길 18,85,88,78,251,84
3588,음식점,카페루시아,제주특별자치도 서귀포시 안덕면 난드르로 49-19,95,85,73,253,84
440,관광지,서귀본향당,제주특별자치도 서귀포시 정방동,96,82,73,251,84
3591,음식점,카페물결,제주특별자치도 제주시 사라봉동길 108-1,84,83,86,253,84
3380,음식점,제갈양,제주특별자치도 제주시 한림읍 한림로 155,90,79,83,252,84
3030,음식점,술도가제주바당,제주특별자치도 제주시 구좌읍 종달로5길 27,71,94,88,253,84
1074,관광지,해품은체험농장,제주특별자치도 서귀포시 성산읍 서성일로 1078-14,100,74,78,252,84
653,관광지,오페라 옴니아 : 라파엘로展,제주특별자치도 서귀포시 안덕면 녹차분재로 218,86,86,77,249,83
3258,음식점,우도왕자이야기,제주특별자치도 제주시 우도면 우도해안길 252,64,120,64,248,83
872,관광지,제주친구,제주특별자치도 서귀포시 동홍로 149,81,86,82,249,83
3197,음식점,오늘은 녹차한잔&쇼핑,제주특별자치도 서귀포시 표선면 중산간동로 4772,90,68,90,248,83
336,관광지,법화사지,제주특별자치도 서귀포시 하원북로35번길 15-28,85,75,90,250,83
1879,숙박,제주 오션팰리스 호텔,제주특별자치도 서귀포시 중앙로 14,84,84,82,250,83
1631,숙박,사랑이꽃피는민박,제주특별자치도 제주시 구좌읍 김녕로19길 12,78,95,77,250,83
3824,음식점,호랑이해장국,제주특별자치도 서귀포시 성산읍 성산중앙로 40,110,88,52,250,83
2238,음식점,거멍국수,제주특별자치도 서귀포시 안덕면 사계로114번길 53-14,84,78,87,249,83
785,관광지,제주대학교병원,제주특별자치도 제주시 아란13길 15,95,91,62,248,83
3488,음식점,지금이순간,제주특별자치도 제주시 애월읍 애월로 15-1,72,67,109,248,83
3482,음식점,중문자연산횟집,제주특별자치도 서귀포시 중문로 11,96,74,78,248,83
233,관광지,라신동,제주특별자치도 제주시 한림읍 귀덕리,86,79,83,248,83
1192,쇼핑,에브리바디빈티지,제주특별자치도 제주시 관덕로8길 31,92,68,88,248,83
56,관광지,고산일과해안도로,제주특별자치도 서귀포시 대정읍 영락하동로 9-6,90,75,85,250,83
1258,숙박,inn jeju 인제주 게스트하우스,제주특별자치도 제주시 한림읍 명월성로 137-14,69,80,99,248,83
343,관광지,별도포구,제주특별자치도 제주시 화북1동 4269-12,91,84,74,249,83
808,관광지,제주불교성지 순례길 절로 가는길 - 정진의 길,제주특별자치도 서귀포시 영실로 246 (하원동),91,87,70,248,83
3458,음식점,제주해물밥,제주특별자치도 제주시 월대3길 14-6,98,71,79,248,83
217,관광지,동귀방파제,제주특별자치도 제주시 애월읍 하귀리,87,77,84,248,83
907,관광지,조함해안도로,제주특별자치도 제주시 조천읍 조천리 3037-3,85,81,84,250,83
2262,음식점,고요남,제주특별자치도 제주시 구남동8길 51,81,86,79,246,82
305,관광지,민오름(구좌읍),제주특별자치도 제주시 구좌읍 비자림로 1456,92,86,68,246,82
1878,숙박,제주 에코 스위츠 펜션,제주특별자치도 서귀포시 중문상로 207-13,73,93,81,247,82
999,관광지,테우마을 수원리 농어촌체험마을,제주시 한림읍 한림해안로 274,74,85,87,246,82
2239,음식점,거부한정식(신제주점),제주특별자치도 제주시 제원4길 3,87,87,72,246,82
918,관광지,좌보미오름,제주특별자치도 서귀포시 표선면 성읍리 산 6,90,83,74,247,82
1778,숙박,에코그린리조트,제주특별자치도 제주시 한림읍 귀덕6길 94,80,86,81,247,82
2872,음식점,빨간집,제주특별자치도 제주시 광양13길 7,86,84,76,246,82
1439,숙박,또랑게스트하우스,제주 제주시 한북로 338,119,74,54,247,82
632,관광지,영남동,제주특별자치도 서귀포시 산록남로 1966-34,79,89,78,246,82
104,관광지,금룡사 템플스테이,제주특별자치도 제주시 구좌읍 김녕로 148-11,85,82,78,245,82
1674,숙박,수상한소금밭게스트하우스,제주특별자치도 제주시 구좌읍 종달동길 36-10,67,88,91,246,82
106,관광지,금성포구,제주특별자치도 제주시 애월읍 금성리 573-1,85,82,80,247,82
3310,음식점,유람위드북스,제주특별자치도 제주시 한경면 조수동2길 54-36,73,87,87,247,82
3593,음식점,카페베트로(CAFE VETRO),제주특별자치도 서귀포시 안덕면 신화역사로304번길 38,80,74,91,245,82
420,관광지,삼양해안도로,제주특별자치도 제주시 삼양2동,86,83,78,247,82
1698,숙박,슬로우리제주 민박,제주특별자치도 제주시 애월읍 엄수로 77,77,76,91,244,81
736,관광지,일출랜드 아트센터,제주특별자치도 서귀포시 성산읍 중산간동로 4150-30,90,75,78,243,81
1177,쇼핑,수풀,제주특별자치도 제주시 한림읍 한수풀로 36 2층,139,49,54,242,81
4,관광지,1112도로,제주특별자치도 제주시 명림로 584 (봉개동),93,68,83,244,81
2274,음식점,공백,제주특별자치도 제주시 구좌읍 동복로 83,72,84,88,244,81
184,관광지,대정면 4.3사건 위령비,제주특별자치도 서귀포시 대정읍 동일하모로 158-3,92,74,78,244,81
1960,숙박,제주하나호텔,제주특별자치도 서귀포시 중문관광로72번길 53,86,80,77,243,81
3415,음식점,제주베이통갈치구이,제주특별자치도 제주시 연대마을길 26-3,85,83,74,242,81
100,관광지,금능포구,제주특별자치도 제주시 한림읍 금능리,81,77,84,242,81
1907,숙박,제주밭담숲,제주특별자치도 제주시 구좌읍 김녕남8길 55-64,81,78,84,243,81
2850,음식점,블루메베이글,제주특별자치도 제주시 가령로4길 3,84,80,80,244,81
1105,관광지,후포해변,제주특별자치도 제주시 추자면 대서5길 87,73,83,88,244,81
2540,음식점,라운지 38,제주특별자치도 제주시 노연로 12,84,79,81,244,81
2362,음식점,낭쿰낭쿰,제주특별자치도 서귀포시 중앙로79번길 4,78,89,75,242,81
409,관광지,산천단곰솔,제주특별자치도 제주시 516로 3041-24,90,83,69,242,81
809,관광지,제주불교성지 순례길 절로 가는길 - 지계의 길,제주특별자치도 제주시 서연길 10,84,87,72,243,81
1354,숙박,눈먼고래,제주특별자치도 제주시 조천읍 조천7길 19-12,82,101,59,242,81
3429,음식점,제주신화월드 윤경양식당,제주특별자치도 서귀포시 안덕면 신화역사로304번길 38,132,61,50,243,81
1426,숙박,동촌하우스,제주특별자치도 제주시 구좌읍 종달논길 61-4,80,80,79,239,80
1081,관광지,현사포구,제주특별자치도 제주시 이호1동,74,79,88,241,80
742,관광지,"자배봉(자배오름,망오름)",제주특별자치도 서귀포시 남원읍 태위로360번길 18,99,81,61,241,80
983,관광지,케이제주해양사업단,제주특별자치도 서귀포시 대정읍 최남단해안로 116,61,99,81,241,80
3445,음식점,제주중문수제맥주,제주특별자치도 서귀포시 천제연로 264 (중문동),88,69,82,239,80
2360,음식점,낭뜰에쉼팡,제주특별자치도 제주시 조천읍 남조로 2343,77,84,79,240,80
479,관광지,성산초등학교 서청특별중대 주둔지,제주특별자치도 서귀포시 성산면 성산리 171-9,86,73,80,239,80
3428,음식점,제주신화월드 F&B,제주특별자치도 서귀포시 안덕면 신화역사로304번길 38,74,74,92,240,80
1389,숙박,더 프라이빗 시로,제주특별자치도 제주시 한경면 신창상동길 20-1,119,57,64,240,80
260,관광지,맛있는 철학자(태반의땅제주),제주특별자치도 서귀포시 토평로50번길 31,72,77,91,240,80
3437,음식점,제주와이너리,제주특별자치도 제주시 애월읍 용흥7길 23,88,80,73,241,80
1732,숙박,아름다운펜션민박,제주특별자치도 제주시 추자면 영흥4길 62,69,86,84,239,80
3422,음식점,제주선 더블랙,제주특별자치도 서귀포시 안덕면 신화역사로304번길 38 제주신화월드 호텔앤리조트 메리어트관 G층,81,83,76,240,80
1876,숙박,제주 메이 더 호텔 카라반빌리지,제주특별자치도 제주시 구좌읍 일주동로 1626,85,74,80,239,80
339,관광지,벨리타,제주특별자치도 제주시 조천읍 중산간동로 1194,81,83,77,241,80
1684,숙박,쉼게스트하우스,제주특별자치도 제주시 한림읍 옹포2길 30,115,79,45,239,80
312,관광지,바람모루,제주특별자치도 서귀포시 서호동,99,67,74,240,80
2094,숙박,하늘고래,제주특별자치도 제주시 한림읍 협재1길 59-4,74,95,71,240,80
1279,숙박,게스트하우스7,제주특별자치도 제주시 용문로 168 (용담 2동) 2층,79,91,70,240,80
2632,음식점,망고레이,제주특별자치도 제주시 우도면 우도로 1,53,129,57,239,80
1153,쇼핑,바이제주,제주특별자치도 제주시 서해안로 626,57,79,103,239,80
293,관광지,문화공간 양,제주특별자치도 제주시 거로남6길 13,85,70,86,241,80
1683,숙박,쉴만한 물가,제주특별자치도 제주시 한림읍 월령안길 28,75,94,70,239,80
1079,관광지,헌마공신김만일기념관,서귀포시 남원읍 서성로 919,78,67,92,237,79
1908,숙박,제주베스트힐 펜션&글램핑,제주특별자치도 제주시 조천읍 남조로 2109-36,92,69,75,236,79
2846,음식점,브와두스,제주특별자치도 제주시 국기로 35,120,75,41,236,79
889,관광지,제주햇살농원,제주특별자치도 제주시 조천읍 북선로 189,100,71,66,237,79
1911,숙박,제주부영호텔엔리조트,제주특별자치도 서귀포시 중문관광로 216,75,89,72,236,79
410,관광지,산호레저,제주특별자치도 제주시 우도면 우도해안길 73,81,71,86,238,79
44,관광지,건강장수마을 산양리 농어촌체험마을,제주시 한경면 중산간서로 3169,88,81,69,238,79
175,관광지,당오름(안덕면),제주특별자치도 서귀포시 안덕면 동광리 산 68-1,80,87,71,238,79
565,관광지,신효 생활개선회,제주특별자치도 서귀포시 효돈순환로 44,74,77,87,238,79
281,관광지,무릉자전거도로(환상자전거길 3구간),제주특별자치도 제주시 구좌읍 구좌해안로 237,96,76,66,238,79
2373,음식점,노라바,제주시 애월읍 구엄길 100,90,84,62,236,79
2327,음식점,김명자굴국밥(제주본점),제주특별자치도 제주시 연북로 168,97,77,64,238,79
995,관광지,태흥포구,제주특별자치도 서귀포시 남원읍 태흥리,80,70,86,236,79
64,관광지,골프탕탕,제주특별자치도 서귀포시 안덕면 산록남로 762번길 71,78,90,67,235,78
55,관광지,고사리숲,제주특별자치도 제주시 애월읍 평화로 2715 제주관광대학교 내 창업보육센터 본관 315호,81,80,74,235,78
965,관광지,추사 유배길 - 2코스 인연의 길,제주특별자치도 제주시 한경면 낙수로 228-9,86,76,71,233,78
517,관광지,송령이골,제주특별자치도 서귀포시 남원읍 한신로143번길 99,97,64,74,235,78
1567,숙박,밸류호텔 서귀포(VALUE HOTEL Seogwipo JS),제주특별자치도 서귀포시 김정문화로 51,88,83,63,234,78
781,관광지,제주다,제주특별자치도 제주시 애월읍 납읍남로 65,74,84,77,235,78
228,관광지,뒤굽은이오름,제주특별자치도 제주시 구좌읍 중산간동로 1989-3,102,66,65,233,78
3345,음식점,인카페온더비치,제주특별자치도 제주시 구좌읍 해맞이해안로 943,75,76,83,234,78
581,관광지,아름다운피부과,"제주특별자치도 제주시 도령로 5 명은빌딩 2,3,5,7층",76,83,74,233,78
661,관광지,옹포천,제주특별자치도 제주시 한림읍 한림로 563,77,78,80,235,78
764,관광지,제주 카카오캠핑,제주특별자치도 제주시 일주서로 7867,74,71,88,233,78
3481,음식점,중문어촌계해녀의집,제주특별자치도 서귀포시 중문관광로 194,90,67,78,235,78
2452,음식점,덕성원,제주특별자치도 서귀포시 태평로401번길 4,87,84,62,233,78
600,관광지,알제이,제주특별자치도 제주시 한경면 고산로 13-4 2F,72,75,86,233,78
1981,숙박,지삿개풍경,제주특별자치도 서귀포시 이어도로 150,83,91,59,233,78
220,관광지,동복환해장성,제주특별자치도 제주시 구좌읍 동복리,85,70,78,233,78
263,관광지,맬튼개 갯담,제주특별자치도 제주시 구좌읍 구좌로 142,66,86,82,234,78
2925,음식점,서광보말칼국수,제주특별자치도 서귀포시 안덕면 중산간서로 1882,103,69,62,234,78
1881,숙박,제주bp게스트하우스 JEJU BP GUESTHOUSE,제주특별자치도 제주시 신대로17길 29,64,91,78,233,78
3585,음식점,카페동백,제주특별자치도 제주시 조천읍 동백로 68,75,76,82,233,78
2919,음식점,생돈우리,제주특별자치도 제주시 우평로 38,75,85,73,233,78
3856,음식점,흑소랑,제주특별자치도 제주시 연북로 631,68,88,77,233,78
301,관광지,미요캔들,제주특별자치도 제주시 구남로4길 8-1,94,69,71,234,78
3688,음식점,톰톰카레,제주특별자치도 제주시 구좌읍 해맞이해안로 1112,59,80,96,235,78
1113,쇼핑,HAN 컬렉션,제주특별자치도 제주시 노연로 12,63,79,92,234,78
921,관광지,중문골프장,제주특별자치도 서귀포시 중문관광로72번길 60 (색달동),79,80,75,234,78
39,관광지,거믄여해안경승지,제주특별자치도 서귀포시 516로,81,74,79,234,78
3002,음식점,쇠소깍오메기식당,제주특별자치도 서귀포시 일주동로 8231,83,67,82,232,77
400,관광지,산방산 수국,제주특별자치도 서귀포시 안덕면 산방로,75,77,80,232,77
2205,음식점,88버거,제주특별자치도 서귀포시 동문로 63 (서귀동),83,72,77,232,77
3311,음식점,유리네,제주특별자치도 제주시 연북로 146,108,60,63,231,77
1767,숙박,언니네여인숙,제주특별자치도 제주시 구좌읍 종달논길 54,72,75,83,230,77
650,관광지,오백나한,제주특별자치도 서귀포시 영실로 245 (하원동),92,76,64,232,77
761,관광지,제주 더팔팔농장,제주특별자치도 서귀포시 성산읍 독자봉로60번길 20,73,65,93,231,77
819,관광지,제주시 충혼묘지 4·3추모비(박진경 추도비),제주특별자치도 제주시 노형동 산 19-2,80,83,68,231,77
3129,음식점,애월빵공장앤카페,제주특별자치도 제주시 애월읍 금성5길 42-15,78,76,76,230,77
640,관광지,예술공간 이아,제주특별자치도 제주시 중앙로14길 21,78,81,71,230,77
103,관광지,금룡사,제주특별자치도 제주시 구좌읍 김녕로 148-11,89,74,67,230,77
5,관광지,4·3해원방사탑,제주특별자치도 제주시 신산로 82,95,75,62,232,77
2918,음식점,색달식당,제주특별자치도 서귀포시 색달중앙로 23,66,77,88,231,77
1217,쇼핑,제주허니와인,제주특별자치도 제주시 애월읍 용하길 42 (하가리),89,70,72,231,77
8,관광지,9연대 본부 옛터,제주특별자치도 서귀포시 대정읍 일주서로 2497,77,77,78,232,77
280,관광지,무릉도원마을,제주특별자치도 서귀포시 대정읍 중산간서로 2868,86,69,77,232,77
187,관광지,대정현역사자료전시관,제주특별자치도 서귀포시 대정읍 상모대서로 17,84,71,75,230,77
553,관광지,신양포구,제주특별자치도 서귀포시 성산읍 고성리,74,72,84,230,77
2051,숙박,파크 선샤인 제주,제주특별자치도 서귀포시 남성중로 135번길 1,69,86,75,230,77
2929,음식점,서귀포바당물회,제주특별자치도 서귀포시 태평로 512번길 1-4 107호,74,78,80,232,77
3004,음식점,쇼밥,제주특별자치도 서귀포시 보목로64번길 138,78,76,77,231,77
627,관광지,연대포구,제주특별자치도 제주시 외도2동,82,76,69,227,76
3193,음식점,오가네전복설렁탕,제주특별자치도 서귀포시 중산간동로 7738,73,85,71,229,76
332,관광지,밸런싱 요가,제주특별자치도 제주시 중앙로 492,83,77,68,228,76
1534,숙박,민박하얀집,제주특별자치도 제주시 한림읍 협재1길 9,62,68,98,228,76
265,관광지,멍멍플레이스,제주특별자치도 제주시 애월읍 소길남길 244-5,86,79,62,227,76
1447,숙박,라마다 제주시티호텔,제주특별자치도 제주시 중앙로 304,63,83,81,227,76
234,관광지,라온골프클럽,제주특별자치도 제주시 한경면 용금로 998,81,74,74,229,76
2784,음식점,버터모닝,제주특별자치도 제주시 애월읍 하광로 279,82,94,53,229,76
2275,음식점,공천포식당,제주특별자치도 서귀포시 남원읍 공천포로 89,71,82,76,229,76
1719,숙박,씨사이드아덴,제주특별자치도 서귀포시 중문관광로 124,63,87,77,227,76
956,관광지,천지연기정길,제주특별자치도서귀포시 서귀동 961-33,73,85,71,229,76
1045,관광지,한동환해장성,제주특별자치도 제주시 구좌읍 해맞이해안로 858-1,79,72,78,229,76
550,관광지,신산신양해안도로 (해산물),제주특별자치도 서귀포시 성산읍 고성리,82,69,76,227,76
372,관광지,비블리아성서식물원,제주특별자치도 제주시 한림읍 조성로 17,86,69,74,229,76
501,관광지,소남머리,제주특별자치도 서귀포시 칠십리로 145,71,77,81,229,76
555,관광지,신양해안도로,제주특별자치도 서귀포시 성산읍 신고로,86,63,80,229,76
738,관광지,입산봉(삿갓오름),제주특별자치도 제주시 구좌읍 김녕리 1033-19,79,75,74,228,76
2973,음식점,성읍칠십리식당,제주특별자치도 서귀포시 표선면 성읍정의현로 74,100,58,71,229,76
1114,쇼핑,갈중이,제주특별자치도 서귀포시 안덕면 사계남로216번길 24-61,69,71,87,227,76
1811,숙박,오션스퀘어,서귀포시 환해장성로 667,65,75,88,228,76
1944,숙박,제주카사블랑카펜션,제주특별자치도 서귀포시 학수암로 111 (호근동),75,64,89,228,76
505,관광지,소암현중화기념관,제주특별자치도 서귀포시 소암로 15,67,82,79,228,76
512,관광지,솔동산8경,제주특별자치도 서귀포시 서귀동 솔동산로,86,77,64,227,76
1587,숙박,봄그리고가을호텔&리조트,제주특별자치도 서귀포시 성산읍 해맞이해안로 2652,61,75,92,228,76
2667,음식점,명품한라봉아이스크림,제주특별자치도 서귀포시 성산읍 일주동로 5335,81,72,73,226,75
1412,숙박,돌고래하우스(캠핑장),제주특별자치도 서귀포시 이어도로 826-58,69,77,79,225,75
2685,음식점,목포고을,제주특별자치도 서귀포시 일주서로 968-5,79,80,67,226,75
1892,숙박,제주도푸른산푸른바다,제주특별자치도 제주시 구좌읍 일주동로 3421,71,90,64,225,75
928,관광지,중문카라반,제주특별자치도 서귀포시 이어도로 81,68,73,85,226,75
1576,숙박,베스트웨스턴제주호텔,제주특별자치도 제주시 도령로 27,70,94,62,226,75
929,관광지,중문컨트리클럽,제주특별자치도 서귀포시 중문관광로72번길 60,74,80,71,225,75
1563,숙박,밭담사이,제주특별자치도 제주시 구좌읍 종달로1길 115-1,67,81,77,225,75
3373,음식점,전망대횟집,제주특별자치도 제주시 한림읍 한림해안로 229-14,99,59,67,225,75
968,관광지,추억애거리,제주특별자치도 제주시 도공로 3-3,73,78,75,226,75
255,관광지,마원,제주특별자치도 제주시 조천읍 선흘남4길 264-17,85,68,73,226,75
253,관광지,마복이오름,제주특별자치도 서귀포시 안덕면 산록남로 863,137,46,42,225,75
1678,숙박,수하리839,제주특별자치도 서귀포시 성산읍 온평애향로 21,73,104,47,224,75
237,관광지,레더한,제주특별자치도 서귀포시 남원읍 태위로 773-19,73,77,75,225,75
602,관광지,알프스승마장포니,제주특별자치도 서귀포시 표선면 서성일로 73,74,72,78,224,75
3695,음식점,파리바게트 애월,제주특별자치도 제주시 애월읍 애월로 128,77,78,69,224,75
304,관광지,민속해안로,제주특별자치도 서귀포시 표선면 일주동로 6228,77,85,64,226,75
2085,숙박,프라이빗리조트,제주특별자치도 서귀포시 태평로 130,74,94,57,225,75
648,관광지,오름터 민속마을,제주특별자치도 서귀포시 표선면 성읍정의현로 99,89,69,67,225,75
3642,음식점,코코마마,제주특별자치도 서귀포시 성산읍 일출로 258-11,72,75,79,226,75
556,관광지,신엄포구,제주특별자치도 제주시 애월읍 애월해안로,82,75,68,225,75
2009,숙박,켄싱턴리조트 서귀포,제주특별자치도 서귀포시 이어도로 684 (켄싱턴리조트),64,82,80,226,75
3071,음식점,신우성타운,제주특별자치도 서귀포시 중문관광로72번길 29-9,82,77,67,226,75
3353,음식점,일통이반,제주특별자치도 제주시 중앙로2길 25,69,77,79,225,75
3714,음식점,푸주옥도남점,제주특별자치도 제주시 독짓골4길 4,57,86,82,225,75
1092,관광지,화북환해장성,제주특별자치도 제주시 화북동,84,70,69,223,74
1717,숙박,썬앤문리조트,제주특별자치도 서귀포시 안덕면 사계남로 102,71,85,65,221,74
1220,쇼핑,차귀도 오징어,제주특별자치도 제주시 한경면 고산리,80,69,74,223,74
455,관광지,서귀포해안,제주특별자치도 서귀포시 서호동,65,67,89,221,74
3409,음식점,제주뚝배기,제주특별자치도 서귀포시 성산읍 일출로 255,71,86,65,222,74
497,관광지,세화소품관,제주특별자치도 제주시 구좌읍 해맞이해안로 1422-3,80,74,68,222,74
3556,음식점,춘심이네 본점,제주특별자치도 서귀포시 안덕면 창천중앙로24번길 16,110,83,29,222,74
3063,음식점,신 해바라기분식,제주특별자치도 제주시 관덕로13길 13,103,65,53,221,74
1169,쇼핑,서쪽가게,제주특별자치도 제주시 한림읍 한림로 336,72,71,79,222,74
2859,음식점,비양도식당,제주특별자치도 제주시 한림읍 한림로 167,81,76,65,222,74
730,관광지,이호-내도 해안도로,제주특별자치도 제주시 테우해안로 60,79,66,76,221,74
1713,숙박,썬레이크빌제주,제주특별자치도 서귀포시 성산읍 한도로 49,69,77,77,223,74
323,관광지,방일리공원,제주특별자치도 제주시 정원로 50,82,79,62,223,74
568,관광지,신흥리 동백 & 향나무길,제주특별자치도 서귀포시 남원읍 수망리 59,92,65,64,221,74
1414,숙박,돌담민박,제주특별자치도 제주시 애월읍 하귀12길 18,77,90,56,223,74
3696,음식점,파리바게트 제스코본점,제주특별자치도 제주시 연북로 444,62,80,79,221,74
597,관광지,알오름(성산읍),제주특별자치도 서귀포시 성산읍 시흥상동로,79,77,66,222,74
904,관광지,조천비석거리,제주특별자치도 제주시 조천읍 조천리,72,69,81,222,74
1692,숙박,스테이달하,제주특별자치도 제주시 애월읍 신엄안1길 20,78,75,70,223,74
2376,음식점,노을언덕,제주특별자치도 제주시 서해안로 360,85,70,68,223,74
330,관광지,백제사 템플스테이,제주시 애월읍 광령남6길 54 백제사,88,70,63,221,74
227,관광지,둔지봉,제주특별자치도 제주시 구좌읍 한동리 산 40,84,76,63,223,74
3285,음식점,웅스키친,제주특별자치도 제주시 대동길 17-1,71,68,79,218,73
3338,음식점,이춘옥원조고등어쌈밥,제주특별자치도 제주시 애월읍 일주서로 7213,71,71,78,220,73
1816,숙박,오크하우스,제주특별자치도 제주시 애월읍 하가로 13,50,79,89,218,73
1999,숙박,추자섬민박,제주특별자치도 제주시 추자면 대서5길 86,51,96,73,220,73
3045,음식점,스시호시카이,제주특별자치도 제주시 오남로 90,77,67,75,219,73
3509,음식점,차귀도놀빛바다,제주특별자치도 제주시 한경면 노을해안로 1142  2층,70,72,78,220,73
247,관광지,마라도기원정사,제주특별자치도 서귀포시 대정읍 마라로 87,77,70,71,218,73
3407,음식점,제주돌창고,제주특별자치도 제주시 한경면 조수7길 8,62,72,85,219,73
2840,음식점,부촌홍어,제주특별자치도 제주시 도남로6길 1,98,88,34,220,73
3075,음식점,신화돌담집,제주특별자치도 서귀포시 안덕면 신화역사로304번길 38,81,70,68,219,73
1175,쇼핑,소심한책방,제주특별자치도 제주시 구좌읍 종달동길 29-6,74,58,86,218,73
3447,음식점,제주축협한우플라자,제주특별자치도 제주시 중앙로 415,95,74,51,220,73
178,관광지,대림리선돌,제주특별자치도 제주시 한림읍 대림리,84,75,60,219,73
495,관광지,세미오름(샘이오름),제주특별자치도 제주시 조천읍 대흘리 산 27-8,79,79,61,219,73
1900,숙박,제주리조트,제주특별자치도 제주시 애월읍 가문동상4길 11,63,83,73,219,73
3450,음식점,제주크랩잭,제주특별자치도 제주시 애월읍 애월해안로 765,95,64,59,218,73
291,관광지,문석이오름,제주특별자치도 제주시 구좌읍 송당리,74,79,66,219,73
1795,숙박,연이네다락방 게스트하우스,제주특별자치도 제주시 구좌읍 동복로 56-3,68,76,72,216,72
933,관광지,지그리오름 (큰지그리),제주특별자치도 제주시 조천읍 남조로 2023,67,64,84,215,72
3181,음식점,영림흑돼지가든,제주특별자치도 제주시 한림읍 한수풀로 30,77,70,70,217,72
981,관광지,캘리그라피 오월,제주특별자치도 제주시 오남로 90,78,80,58,216,72
2321,음식점,기억나는집,제주특별자치도 서귀포시 중앙로 6,74,74,68,216,72
3399,음식점,제주광해 애월,제주특별자치도 제주시 애월읍 애월해안로 867 2층,114,61,42,217,72
1856,숙박,이안재,제주특별자치도 제주시 구좌읍 종달로5길 35-1 (종달리),65,76,74,215,72
2649,음식점,메종드쁘띠푸루,제주특별자치도 제주시 신설로7길 3,75,73,68,216,72
3852,음식점,흑돼지돈까스 뷔페 밀라네사,제주특별자치도 제주시 매촌2길 78 (도련1동) 어베인건물 1층,73,68,76,217,72
676,관광지,용수항,제주특별자치도 제주시 한경면 용수리,68,78,71,217,72
3332,음식점,이어도식당,제주특별자치도 서귀포시 표선면 성읍정의현로22번길 10-1,95,66,55,216,72
1005,관광지,통오름,제주특별자치도 서귀포시 성산읍 신산리 1754-1,71,77,68,216,72
744,관광지,장전리 벚꽃축제길,제주특별자치도 제주시 애월읍 광상로 403,86,76,54,216,72
578,관광지,아라리오뮤지엄동문모텔2,제주특별자치도 제주시 산지로 23,78,72,66,216,72
179,관광지,"대수산봉(큰물뫼,물미오름)",제주특별자치도 서귀포시 성산읍 서성일로1168번길 89-17,71,76,69,216,72
88,관광지,궁대오름(궁대악),제주특별자치도 서귀포시 성산읍 금백조로 446,98,61,57,216,72
1486,숙박,르페도라,제주특별자치도 서귀포시 남원읍 신례중앙로 6,55,67,95,217,72
2366,음식점,냠냠제주,제주특별자치도 제주시 조천읍 신촌9길 8,57,74,84,215,72
533,관광지,수월이못,제주특별자치도 서귀포시 대정읍 안성리 1747,76,69,70,215,72
1360,숙박,느르왓,제주특별자치도 제주시 한경면 고산중길 23,63,81,72,216,72
3594,음식점,카페비글,제주특별자치도 제주시 조천읍 신촌남1길 69-1,68,80,68,216,72
1297,숙박,그랜드메르호텔,제주특별자치도 서귀포시 논짓물로 45,68,84,63,215,72
375,관광지,비양도등대,제주특별자치도 제주시 한림읍 비양도길 84비양도,77,73,66,216,72
2103,숙박,하도하도 3200,제주특별자치도 제주시 구좌읍 면수1길 38,78,70,67,215,72
1636,숙박,산토리니 펜션,제주시 애월읍 애월해안로 774,67,82,68,217,72
1150,쇼핑,바다보석,제주특별자치도 서귀포시 중앙로4번길 20,70,71,71,212,71
380,관광지,비치미오름,제주특별자치도 제주시 구좌읍 송당리 산 255-1,86,67,61,214,71
2847,음식점,블랑로쉐,제주특별자치도 제주시 우도면 우도해안길 783,79,76,57,212,71
3716,음식점,풍림다방,제주특별자치도 제주시 구좌읍 중산간동로 2267-4,63,82,69,214,71
294,관광지,문화빳데리 충전소,제주특별자치도 서귀포시 중정로 76,81,67,65,213,71
2198,음식점,24시 전주명가콩나물국밥,제주시 구산로 59,81,77,56,214,71
2959,음식점,성미가든,제주특별자치도 제주시 조천읍 교래1길 2,68,77,69,214,71
310,관광지,바늘오름,제주특별자치도 제주시 조천읍 교래리 산 108,80,69,63,212,71
19,관광지,가세오름,제주특별자치도 서귀포시 표선면 녹산로 554,80,64,68,212,71
3142,음식점,어머니와고등어,제주특별자치도 제주시 도두봉2길 43,83,63,66,212,71
258,관광지,만벵듸 공동장지,제주특별자치도 제주시 한림읍 갯거리오름길 114,77,66,69,212,71
353,관광지,볼레낭길,제주특별자치도 서귀포시 안덕면 감산리 1049,76,71,67,214,71
2392,음식점,닐모리동동,제주특별자치도 제주시 서해안로 452,61,89,63,213,71
2081,숙박,표선이레하우스,제주특별자치도 서귀포시 표선면 표선당포로 9,68,75,70,213,71
1531,숙박,미쓰홍당무하우스,제주특별자치도 제주시 구좌읍 평대4길 20-1,81,66,66,213,71
2211,음식점,S BAR,제주특별자치도 서귀포시 안덕면 신화역사로304번길 38,79,63,71,213,71
1407,숙박,도도펜션,제주특별자치도 서귀포시 안덕면 대평감산로 47,71,68,72,211,70
200,관광지,도두해안도로,제주특별자치도 제주시 도두2동 706-3,79,63,69,211,70
2659,음식점,명리동식당,제주특별자치도 제주시 한경면 녹차분재로 498,76,65,70,211,70
1736,숙박,아모렉스리조트,제주특별자치도 제주시 서해안로 216,68,78,63,209,70
2674,음식점,모리노아루요,제주특별자치도 제주시 애월읍 하소로 769-58,64,72,75,211,70
610,관광지,액트(AC.lll.T) 볼링장,제주특별자치도 서귀포시 안덕면 신화역사로304번길 98,78,73,59,210,70
2077,숙박,포트애비뉴,제주특별자치도 서귀포시 대포동서로 63-19,57,149,3,209,70
717,관광지,육시우영,제주특별자치도 제주시 애월읍 하가리,62,76,72,210,70
3014,음식점,수제홍과일모찌,제주특별자치도 제주시 연동14길 14,70,79,60,209,70
3402,음식점,제주기정떡,제주특별자치도 제주시 애월읍 평화로 2747,83,71,57,211,70
2182,숙박,환상의민박,제주특별자치도 서귀포시 대정읍 마라로 45,72,58,81,211,70
3665,음식점,탐라반상,제주특별자치도 제주시 한경면 녹차분재로 462,70,82,57,209,70
3499,음식점,진미명가식당,제주특별자치도 서귀포시 안덕면 사계남로 167,59,69,82,210,70
1006,관광지,통일관,제주특별자치도 제주시 신산로9길 4,67,75,67,209,70
3620,음식점,카페헤밍웨이,제주특별자치도 제주시 한림읍 한림로 431,64,87,60,211,70
309,관광지,바구스서핑스쿨,제주특별자치도 제주시 테우해안로 143,74,60,77,211,70
2734,음식점,바그다드,제주특별자치도 제주시 서광로32길 38,59,109,41,209,70
60,관광지,고포잇다이브센터,제주특별자치도 서귀포시 이어도로 685-1,63,59,87,209,70
2730,음식점,민경이네어등포해녀촌,제주특별자치도 제주시 구좌읍 해맞이해안로 830,78,53,76,207,69
1243,숙박,1915 지오하우스,제주특별자치도 서귀포시 성산읍 성산등용로 14,73,80,54,207,69
3040,음식점,스마일러 카페,제주특별자치도 제주시 애월읍 상고길 47,72,74,60,206,69
641,관광지,예절이오름(여절악),제주특별자치도 서귀포시 남원읍 신흥리 산 18,84,65,58,207,69
205,관광지,독자봉,제주특별자치도 서귀포시 성산읍 신산리 1785,66,64,76,206,69
587,관광지,아침한의원,제주특별자치도 제주시 한림읍 한림중앙로 31,68,74,65,207,69
422,관광지,삼화포구,제주특별자치도 제주시 서흘1길 26,66,72,69,207,69
3442,음식점,제주이야기,제주특별자치도 제주시 구좌읍 행원로13길 67(행원리),75,71,62,208,69
718,관광지,율랜드 다이브센터,제주특별자치도 서귀포시 칠십리로 490,59,66,82,207,69
2100,숙박,하니크라운호텔,제주특별자치도 제주시 삼성로 10,90,66,52,208,69
2636,음식점,망고홀릭 성산일출봉점,제주특별자치도 서귀포시 성산읍 일출로 282,55,80,73,208,69
1359,숙박,뉴코리아유스호스텔,제주특별자치도 제주시 애월읍 하소로 769-15,61,70,76,207,69
1649,숙박,섬타임즈,제주특별자치도 제주시 연대마을길 66-1,48,76,84,208,69
3295,음식점,월정리갈비밥,제주특별자치도 제주시 구좌읍 월정7길 46,57,61,90,208,69
3579,음식점,카페갤러리,제주특별자치도 제주시 조천읍 남조로 1717-24,110,41,57,208,69
3417,음식점,제주본초협동조합,제주특별자치도 제주시 한경면 고산로2길 22-13,92,62,53,207,69
201,관광지,도령모루,제주특별자치도,75,69,63,207,69
3061,음식점,시흥해녀의집,제주특별자치도 서귀포시 성산읍 시흥하동로 114,70,65,73,208,69
1661,숙박,소랑풀빌라,제주특별자치도 제주시 조천읍 곱은달남길 218,78,65,65,208,69
729,관광지,이편한치과,제주특별자치도 제주시 연북로 527 반디빌딩 5층,61,81,65,207,69
2780,음식점,백양닭집,제주특별자치도 제주시 서문로6길 7,72,69,66,207,69
3090,음식점,아라파파 a la papa,제주특별자치도 제주시 국기로3길 2,75,74,57,206,69
1880,숙박,제주WE호텔,제주도 서귀포시 1100로 453-95,74,72,60,206,69
971,관광지,추자도등대,제주특별자치도 제주시 추자면 영흥4길 43,67,66,73,206,69
2495,음식점,돌토고리족욕카페,제주특별자치도 서귀포시 표선면 표선당포로 16-4,73,72,63,208,69
755,관광지,정의현 일관헌,제주특별자치도 서귀포시 표선면 성읍리 690,70,65,72,207,69
1805,숙박,오름게스트하우스,제주특별자치도 제주시 구좌읍 충렬로 147-19,64,71,73,208,69
2905,음식점,삼대국수회관 신제주점,제주특별자치도 제주시 신대로20길 32,87,64,54,205,68
3296,음식점,월정리로와,제주특별자치도 제주시 구좌읍 해맞이해안로 472,47,112,45,204,68
2975,음식점,성화정,제주특별자치도 서귀포시 안덕면 신화역사로304번길 38,62,68,74,204,68
551,관광지,신산환해장성,제주특별자치도 서귀포시 성산읍 신산리,75,74,55,204,68
365,관광지,불카분낭 (불타버린 나무),제주특별자치도 제주시 조천읍 선흘리 1136-2,76,71,58,205,68
316,관광지,박성내,제주특별자치도 제주시 기자길 5,77,68,59,204,68
1680,숙박,숲골 제주독채펜션,제주특별자치도 제주시 조천읍 선교로 211-19,109,53,43,205,68
3211,음식점,오백장군과 까마귀,제주특별자치도 서귀포시 영실로 495,120,47,37,204,68
1199,쇼핑,우생당,제주특별자치도 제주시 관덕로 42,63,68,72,203,68
342,관광지,별도연대,제주특별자치도 제주시 화북1동 1537,80,60,65,205,68
1281,숙박,게으른소나기,제주 제주시 구좌읍 계룡길 45-6,59,72,72,203,68
1520,숙박,무이비엔,제주특별자치도 제주시 구좌읍 한동로4길 3,91,68,46,205,68
3248,음식점,용두암해녀촌,제주특별자치도 제주시 용해로 11,87,65,52,204,68
2776,음식점,백기해녀의 집,제주특별자치도 서귀포시 성산읍 일출로 88-19,65,67,72,204,68
1832,숙박,우도피아,제주특별자치도 제주시 우도면 영일진사길 51-40,73,76,55,204,68
760,관광지,제원한의원,제주특별자치도 제주시 신대로14길 36 2층,69,74,61,204,68
1644,숙박,서귀포호텔  카라반,제주특별자치도 서귀포시 상예로 319,68,60,77,205,68
47,관광지,걸서악오름,제주특별자치도 서귀포시 남원읍 하례로 393,81,67,55,203,68
3420,음식점,제주샘주 영농협동조합,제주특별자치도 제주시 애월읍 애원로 283,75,70,59,204,68
329,관광지,백제사,제주시 애월읍 광령남6길 54 백제사,73,63,67,203,68
170,관광지,단산과 방사탑,제주특별자치도 제주시 조천읍 신흥로1길 25,76,64,65,205,68
1227,쇼핑,팰롱팰롱 빛나는,제주특별자치도 제주시 구좌읍 월정3길 58,60,60,85,205,68
2301,음식점,그때그집 함덕,제주특별자치도 제주시 조천읍 조함해안로 486,60,68,77,205,68
414,관광지,삼밭구석 & 동광리4·3희생자위령비,제주특별자치도 서귀포시 안덕면 동광리 1425 일대,88,58,59,205,68
74,관광지,관음사 군 주둔지 옛터,제주특별자치도 제주시 산록북로 660,72,64,68,204,68
804,관광지,제주베스트힐,제주특별자치도 제주시 조천읍 남조로 2109-38,64,56,84,204,68
2625,음식점,만조이천쌀밥,제주특별자치도 서귀포시 성산읍 성산중앙로 5,84,51,67,202,67
2029,숙박,탐탐56,제주특별자치도 제주시 구좌읍 상하도길 56,60,92,48,200,67
566,관광지,신효베스트마을,제주특별자치도 서귀포시 일주동로 8190,70,61,70,201,67
3470,음식점,주상절리회국수,제주특별자치도 서귀포시 대포로 174,93,52,55,200,67
3782,음식점,해녀김밥 본점,제주특별자치도 제주시 조천읍 조함해안로 490 1층,69,64,69,202,67
1030,관광지,핀크스 골프클럽,제주특별자치도 서귀포시 안덕면 산록남로 863,73,57,71,201,67
2619,음식점,만선식당,제주특별자치도 서귀포시 대정읍 하모항구로 44,68,76,58,202,67
407,관광지,산지항 옛터,제주특별자치도 제주시 연무정길 28 (건입동)일대,74,57,70,201,67
780,관광지,제주농업학교 옛터,제주특별자치도 제주시 전농로 100,79,62,59,200,67
3810,음식점,헬로키티아일랜드카페,제주특별자치도 서귀포시 안덕면 한창로 340,75,77,50,202,67
69,관광지,곽지패총,제주특별자치도 제주시 애월읍 곽지리 2043-1,70,71,60,201,67
2181,숙박,화인호텔,제주특별자치도 서귀포시 칠십리로 87,56,67,79,202,67
1423,숙박,동양콘도,제주시 애월읍 애월해안로 708,74,69,59,202,67
2703,음식점,문어빵굽는 문빵9 서귀포올레시장,제주특별자치도 서귀포시 중앙로62번길 18,101,47,52,200,67
356,관광지,부대악오름,제주특별자치도 제주시 조천읍 선흘리 산 103,77,70,54,201,67
905,관광지,조천중학원 옛터,제주특별자치도 제주시 조천읍 신북로 264,64,68,68,200,67
1139,쇼핑,라온명품관,제주특별자치도 제주시 한림읍 금능남로 127,50,58,92,200,67
3555,음식점,춘심이네 2호점,제주특별자치도 제주시 1100로 3114,80,79,41,200,67
1112,쇼핑,B일상잡화점,제주특별자치도 서귀포시 성산읍 오조로 93,65,68,67,200,67
1985,숙박,천상의노을,제주특별자치도 제주시 애월읍 애월해안로 424,67,66,69,202,67
1120,쇼핑,그림책방 & 카페노란우산,제주특별자치도 제주시 애월읍 하광로 515,66,63,72,201,67
1291,숙박,구름밭하우스,제주특별자치도 제주시 구좌읍 문주란로 142,50,81,70,201,67
1206,쇼핑,제일토산품,제주특별자치도 제주시 관덕로 22-1,94,58,48,200,67
2110,숙박,하얀도화지,제주특별자치도 서귀포시 하예로44번길 1,98,63,40,201,67
1366,숙박,다락마마,제주특별자치도 제주시 구좌읍 상하도길 46-16,64,79,59,202,67
2672,음식점,모래비카페,제주특별자치도 제주시 구좌읍 해맞이해안로 462,65,65,72,202,67
2717,음식점,미번베트남쌀국수,제주특별자치도 제주시 한림읍 한림로5길 23,58,64,79,201,67
1723,숙박,씨앤하우스,제주특별자치도 제주시 조천읍 조천9길 10,57,103,38,198,66
1161,쇼핑,사회복지법인 평화의마을,제주특별자치도 서귀포시 대정읍 중산간서로 2195-12,72,80,46,198,66
1159,쇼핑,뷰티풀제주,제주특별자치도 제주시 용마로4길 5-3,59,74,64,197,66
1016,관광지,평수포구,제주특별자치도 제주시 한림읍 한림해안로 297-1,62,63,74,199,66
1327,숙박,나무아래독채펜션,제주특별자치도 제주시 구좌읍 송당서길 51-1,59,71,69,199,66
3360,음식점,잇칸시타,제주특별자치도 제주시 애월읍 신엄안2길 54-1,74,73,50,197,66
2907,음식점,삼무국수,제주특별자치도 제주시 삼무로3길 46-1,72,58,68,198,66
3466,음식점,종달해녀의집,제주특별자치도 제주시 구좌읍 해맞이해안로 2276,71,70,57,198,66
2623,음식점,만원의행복,제주특별자치도 제주시 신대로7길 9,64,73,61,198,66
102,관광지,금덕무환자나무및팽나무군락,제주특별자치도 제주시 애월읍 유수암리 1920,69,61,67,197,66
2593,음식점,마라도에서온자장면집,제주특별자치도 서귀포시 안덕면 화순해안로 109,76,61,61,198,66
3759,음식점,한라축산정육식당 노형점,제주특별자치도 제주시 1100로 3128,71,71,55,197,66
3103,음식점,아찌국밥,제주특별자치도 제주시 한경면 고산로 34,64,83,51,198,66
3335,음식점,이익새양과점,제주특별자치도 제주시 한림읍 명월성로 16,70,64,63,197,66
3209,음식점,오마이양대창 제주외도점,제주특별자치도 제주시 우정로 20,75,62,60,197,66
953,관광지,천주교 순례길 - 신축화해길,제주특별자치도 제주시 관덕로8길 14,61,70,68,199,66
1920,숙박,제주스웨덴리조트펜션,제주특별자치도 제주시 한림읍 명재로 100-45,54,86,57,197,66
1708,숙박,신화관 제주신화월드 호텔 앤 리조트,제주특별자치도 서귀포시 안덕면 신화역사로304번길 38 신화관 제주신화월드 호텔 앤 리조트,62,62,73,197,66
3066,음식점,신산리마을카페,제주특별자치도 서귀포시 성산읍 환해장성로 33,60,68,70,198,66
1947,숙박,제주토비스콘도,제주특별자치도 제주시 애월읍 애월로1길 8,64,79,54,197,66
3455,음식점,제주한면가,제주특별자치도 제주시 조천읍 북선로 373,66,77,56,199,66
3570,음식점,카페 글렌코,제주특별자치도 제주시 구좌읍 비자림로 1202,100,55,44,199,66
2101,숙박,하도리보통날,제주특별자치도 제주시 구좌읍 하도1길 33,76,70,53,199,66
2102,숙박,하도리일번지,제주특별자치도 제주시 구좌읍 해맞이해안로 1860,63,66,70,199,66
1261,숙박,가비오타 펜션,제주특별자치도 제주시 구좌읍 해맞이해안로 2030 가동,50,67,81,198,66
1877,숙박,제주 벨루가,제주특별자치도 서귀포시 대정읍 영락하동로85번길 41-1,55,78,66,199,66
1643,숙박,서귀포푸른바다,제주도 서귀포시 남성로128번길 37-10,54,77,66,197,66
1726,숙박,씨오르리조트,제주특별자치도 서귀포시 이어도로 989,54,69,71,194,65
3125,음식점,애월그때그집 본점,제주특별자치도 제주시 애월읍 애월해안로 97,79,67,50,196,65
3672,음식점,태광식당,제주특별자치도 제주시 탑동로 144,56,68,71,195,65
737,관광지,임문숙 가족 헛묘,제주특별자치도 서귀포시 안덕면 동광리 807-4,71,62,62,195,65
2039,숙박,토스카나호텔,제주특별자치도 서귀포시 용흥로66번길 158-7,60,71,63,194,65
3779,음식점,함덕해물라면오빠네,제주특별자치도 제주시 조천읍 평사길 2,69,63,63,195,65
3574,음식점,카페 보름왓,제주특별자치도 서귀포시 표선면 번영로 2350-104,97,54,45,196,65
2645,음식점,메로식당,제주특별자치도 서귀포시 중정로91번길 16,63,71,62,196,65
2052,숙박,파크빌리지,제주특별자치도 제주시 애월읍 상귀서길 82-12,133,41,21,195,65
3175,음식점,연미정,제주특별자치도 제주시 세평항로 14,54,67,74,195,65
703,관광지,월라사,제주특별자치도 서귀포시 효돈순환로 415,76,56,63,195,65
2600,음식점,마마롱(애월),제주시 애월읍 평화로 2783,66,61,68,195,65
1165,쇼핑,서귀포농협하나로마트,제주특별자치도 서귀포시 516로 40,194,0,0,194,65
1162,쇼핑,산호상점,제주특별자치도 제주시 구좌읍 김녕로2길 20,56,52,86,194,65
2532,음식점,뚱보조개　,제주특별자치도 제주시 서광로28길 53,66,75,54,195,65
2497,음식점,돌하르방식당,제주특별자치도 제주시 한림읍 한림로 300,67,74,55,196,65
1324,숙박,끄라비펜션,제주특별자치도 서귀포시 토평로148번길 28,69,65,62,196,65
3200,음식점,오드랑베이커리,제주특별자치도 제주시 조천읍 조함해안로 552-3,71,63,62,196,65
637,관광지,영천악(영천오름),제주특별자치도 서귀포시 516로 652,70,58,66,194,65
2509,음식점,동우통닭,제주특별자치도 제주시 도남로 76,52,75,66,193,64
3708,음식점,평대스낵,제주특별자치도 제주시 구좌읍 대수길 7,63,58,70,191,64
2852,음식점,블루사이공,제주특별자치도 제주시 애월읍 중산간서로 6333,70,72,50,192,64
1604,숙박,블랙스톤리조트,제주특별자치도 제주시 한림읍 한창로 925-122,53,77,62,192,64
3088,음식점,아뜰리에 제주명월,제주특별자치도 서귀포시 안덕면 병악로 31,59,63,70,192,64
62,관광지,곤물,제주특별자치도 서귀포시 안덕면 화순서서로64번길 64-4,69,55,67,191,64
1826,숙박,와이리조트 제주,제주특별자치도 서귀포시 안덕면 화순중앙로124번길 75,56,72,65,193,64
2443,음식점,더 코브,제주특별자치도 서귀포시 안덕면 신화역사로304번길 38 제주신화월드 메리어트 리조트관 GF,70,63,59,192,64
1965,숙박,제주해조대펜션,제주특별자치도 제주시 한림읍 한림로 339,45,57,89,191,64
3219,음식점,오현불백,제주특별자치도 제주시 성지로 58-2,76,60,56,192,64
3252,음식점,우도 풍원,제주특별자치도 제주시 우도면 우도해안길 340,70,64,59,193,64
1241,쇼핑,화북종합시장,제주특별자치도 제주시 진동로5길 31,56,77,60,193,64
2259,음식점,고사리식당,제주특별자치도 제주시 조천읍 번영로 1680,86,46,59,191,64
180,관광지,대수포구,제주특별자치도 제주시 한림읍 수원리 1027-7,62,56,75,193,64
3741,음식점,하비마카롱,제주특별자치도 제주시 연삼로 449,63,67,63,193,64
3693,음식점,파리바게뜨 성산일출봉점,제주특별자치도 서귀포시 성산읍 일출로 270-1,65,73,55,193,64
3612,음식점,카페코지,제주특별자치도 서귀포시 성산읍 한도로 200,62,79,52,193,64
3375,음식점,전원일기,제주특별자치도 서귀포시 일주동로 8713,74,62,56,192,64
1010,관광지,"판포오름 (널개오름, 板浦岳)",제주특별자치도 제주시 한경면 판포리 934,63,62,68,193,64
1627,숙박,뿌리게스트하우스,제주특별자치도 제주시 한경면 용수1길 3,86,53,52,191,64
714,관광지,유건에오름,제주특별자치도 서귀포시 성산읍 난산리 2302,84,58,50,192,64
2490,음식점,돌집식당,제주특별자치도 서귀포시 표선면 서성일로 23,55,70,63,188,63
1278,숙박,게스트하우스 클럽 제이제이,제주특별자치도 서귀포시 천제연로 103-15,61,75,54,190,63
1111,쇼핑,(주)메이드인제주,제주특별자치도 제주시 조천읍 중산간동로 804-16,58,59,72,189,63
2612,음식점,만덕식당,제주특별자치도 제주시 한경면 노을해안로 1168,66,60,64,190,63
2950,음식점,섬채,제주특별자치도 제주시 오라로 61,64,67,57,188,63
23,관광지,각시바우오름,제주특별자치도 서귀포시 호근동 2112,77,50,61,188,63
208,관광지,돈대산,제주특별자치도 제주시 추자면 예초리 산 67-1,67,65,58,190,63
3685,음식점,토이다방,제주특별자치도 제주시 승천로 45,60,72,56,188,63
541,관광지,스쿠버스쿨,제주특별자치도 제주시 서해안로 301,45,58,87,190,63
759,관광지,제스피 맥주협동조합 양조장,제주특별자치도 서귀포시 남원읍 서성로652번길 63-3,67,58,63,188,63
1242,숙박,메리어트관 제주신화월드 호텔앤리조트,제주특별자치도 서귀포시 안덕면 신화역사로304번길 38,62,62,66,190,63
277,관광지,묘산봉 (괴살메),제주특별자치도 제주시 구좌읍 김녕리 2723,67,61,62,190,63
3191,음식점,옛날옛적,제주특별자치도 서귀포시 성산읍 일주동로 4660,70,65,54,189,63
3148,음식점,어부피자,제주특별자치도 서귀포시 성산읍 서성일로 1078-14,70,51,68,189,63
694,관광지,웃세오름(족은오름),제주특별자치도 제주시 애월읍 평화로,67,66,55,188,63
89,관광지,귀덕연대,제주특별자치도 제주시 한림읍 귀덕14길 14-5,61,69,60,190,63
1718,숙박,쏠레 민박,제주특별자치도 서귀포시 성산읍 성산등용로 96-1,61,66,61,188,63
3251,음식점,용출횟집,제주특별자치도 제주시 용담3동 505,78,52,58,188,63
2269,음식점,골목집갈치와고등어,제주특별자치도 서귀포시 표선면 표선백사로110번길 5-10,89,55,44,188,63
2549,음식점,레드팬더,제주특별자치도 제주시 신대로18길 51,58,72,58,188,63
2003,숙박,캐빈타운,제주특별자치도 제주시 애월읍 가문동상2길 29-3,53,64,72,189,63
2093,숙박,하녹펜션,제주특별자치도 제주시 애월읍 하광로 181-1,71,72,47,190,63
2944,음식점,석촌식당,제주특별자치도 제주시 중앙로2길 33,72,49,68,189,63
1076,관광지,핸즈웍스,제주특별자치도 제주시 한림읍 귀덕로 78,56,69,64,189,63
2968,음식점,성산해오름식당,제주특별자치도 서귀포시 성산읍 일출로 260,55,63,70,188,63
1322,숙박,꿈꾸는섬 게스트하우스,제주특별자치도 제주시 조천읍 조천3길 27-1,61,66,62,189,63
975,관광지,칠머리길,제주특별자치도 제주시 칠머리길 1,60,64,64,188,63
3844,음식점,회춘,제주특별자치도 제주시 조천읍 신북로 489,57,63,68,188,63
2223,음식점,가파도 용궁정식,제주특별자치도 서귀포시 대정읍 가파로67번길 7,63,76,49,188,63
2472,음식점,도희네칼국수,제주특별자치도 서귀포시 안덕면 중산간서로 1957,58,69,63,190,63
2229,음식점,감저카페,제주특별자치도 서귀포시 대정읍 대한로 22,58,69,62,189,63
3361,음식점,자리돔횟집,제주특별자치도 서귀포시 동홍동로 7,74,41,74,189,63
2201,음식점,24시얼큰시원생고기김치찌개노형점,제주특별자치도 제주시 수덕5길 5,122,42,24,188,63
77,관광지,광령귤나무,제주특별자치도 제주시 애월읍 광령8길 24-2,67,65,58,190,63
2183,숙박,활엽수 게스트하우스,제주 서귀포시 상모대서로 20번길 44,64,65,61,190,63
577,관광지,아라리오뮤지엄동문모텔1,제주특별자치도 제주시 산지로 37-5,69,60,61,190,63
1429,숙박,두베하우스,제주특별자치도 제주시 구좌읍 상하도길 46-12,55,75,60,190,63
3138,음식점,어림향,제주특별자치도 제주시 서사로24길 22,62,64,64,190,63
932,관광지,지그리오름,제주특별자치도 제주시 조천읍 교래리 산 137-1,65,69,55,189,63
3709,음식점,포도원흑돼지,제주특별자치도 제주시 1100로 3155,71,68,49,188,63
3857,음식점,흑염소마루,제주특별자치도 서귀포시 남원읍 태위로663번길 1-1,82,58,49,189,63
2901,음식점,살롱드라방 SALON de LAVANT,제주특별자치도 제주시 애월읍 하가로 146-9,57,73,59,189,63
3098,음식점,아이갓에브리씽,제주특별자치도 제주시 문연로 6,59,60,66,185,62
3774,음식점,함덕마당,제주특별자치도 제주시 조천읍 조함해안로 586,64,58,64,186,62
1117,쇼핑,곱은달사진관,제주특별자치도 제주시 조천읍 곱은달길 24,55,67,63,185,62
3530,음식점,천하대장군,제주특별자치도 제주시 진군4길 30,61,62,62,185,62
3278,음식점,우정횟집,제주특별자치도 제주시 서부두길 16,81,69,37,187,62
1842,숙박,위미모루왓,제주특별자치도 서귀포시 남원읍 위미항구로 51 (위미리),52,65,68,185,62
1693,숙박,스테이지게스트하우스,제주특별자치도 제주시 구좌읍 해맞이해안로 2361,55,70,60,185,62
3297,음식점,월정리에서브런치,제주특별자치도 제주시 구좌읍 월정3길 53-4,53,61,73,187,62
3169,음식점,엠 라운지 M Lounge,제주 서귀포시 안덕면 신화역사로304번길 38 메리어트관 제주신화월드 호텔앤리조트 G층,56,55,75,186,62
1302,숙박,그림같은집,제주도 서귀포시 법환상로22번길 71,59,63,63,185,62
3733,음식점,하누가물애,제주특별자치도 제주시 조천읍 신북로 409,63,83,40,186,62
215,관광지,동계 정온 유허비,제주특별자치도 서귀포시 대정읍 안성리,58,66,61,185,62
1228,쇼핑,펠롱잡화점,제주특별자치도 제주시 구좌읍 세평항로 45,63,55,68,186,62
3162,음식점,에스프레소 라운지,제주특별자치도 제주시 한라대학로 1 (노형동),57,64,66,187,62
1583,숙박,보로미 민박,제주특별자치도 제주시 애월읍 고성서3길 20-1,48,74,63,185,62
1071,관광지,해비치컨트리클럽제주,제주특별자치도 서귀포시 남원읍 원님로 399번길 319,64,57,65,186,62
1617,숙박,비오하우스,제주특별자치도 제주시 구좌읍 월정3길 53-5,59,71,57,187,62
696,관광지,원동,제주특별자치도 제주시 애월읍 소길리 1364 일대,70,58,57,185,62
624,관광지,에버리스 골프리조트,제주특별자치도 제주시 애월읍 평화로 1693-75,58,61,67,186,62
2342,음식점,꽃담팥집카페,제주 서귀포시 성산읍 일출로 284-7,63,62,60,185,62
2240,음식점,게우지코지 카페,제주특별자치도 서귀포시 보목포로 177,68,55,60,183,61
504,관광지,소수산봉(족은물뫼),제주특별자치도 서귀포시 성산읍 고성리 887,65,58,59,182,61
2741,음식점,바다를본돼지(판포점),제주특별자치도 제주시 한경면 판포1길 16,75,55,52,182,61
3528,음식점,천제연토속음식점,제주특별자치도 서귀포시 천제연로 45,53,58,73,184,61
3675,음식점,탭하우스더코너,제주특별자치도 제주시 도령로 27,53,67,63,183,61
3154,음식점,어진이네 횟집,제주특별자치도 서귀포시 보목포로 93,58,58,67,183,61
1285,숙박,골드원호텔 & 스위트,제주특별자치도 서귀포시 이어도로 1032,51,65,67,183,61
2876,음식점,뽈살집,제주특별자치도 서귀포시 중정로91번길 37,70,56,57,183,61
3567,음식점,카이로스,제주특별자치도 제주시 애월읍 장유길 49-39,52,72,59,183,61
756,관광지,정주항,제주특별자치도 제주시 조천읍 함덕리,59,55,69,183,61
3807,음식점,허파곶자왈화덕피자,제주특별자치도 서귀포시 안덕면 녹차분재로 58,62,54,68,184,61
674,관광지,용둠범목제계단길,제주특별자치도 제주시 추자면 영흥리,61,61,62,184,61
521,관광지,송악힐링풋스킨,제주특별자치도 서귀포시 대정읍 송악관광로 399,62,68,54,184,61
3327,음식점,이드레국수,제주특별자치도 서귀포시 천제연로 93,60,61,63,184,61
2358,음식점,남양수산,제주특별자치도 서귀포시 성산읍 고성동서로56번길 11,57,73,52,182,61
1834,숙박,우리희망이 게스트하우스,제주시 조천읍 신흥관전길 60-1,57,62,64,183,61
2508,음식점,동양식당,제주특별자치도 제주시 동문로6길 4,68,57,59,184,61
2471,음식점,도토리키친,제주특별자치도 제주시 북성로 59,56,66,61,183,61
1688,숙박,스위트호텔 제주,제주특별자치도 서귀포시 중문관광로72번길 67,71,66,46,183,61
2480,음식점,돈사촌 외도점,제주특별자치도 제주시 우평로 283,59,74,49,182,61
1762,숙박,애월해안누리펜션(구 하얀둥지펜션),제주특별자치도 제주시 애월읍 애월해안로 298,62,69,53,184,61
87,관광지,굿다이버,제주특별자치도 서귀포시 중산간서로 41 (강정동),58,63,61,182,61
2863,음식점,비자림국수집,제주특별자치도 제주시 구좌읍 비자숲길 46,52,70,62,184,61
2385,음식점,뉴남원분식,제주특별자치도 서귀포시 남원읍 태위로679번길 2,59,69,54,182,61
3465,음식점,종달리엔 엄마식당,제주특별자치도 제주시 구좌읍 종달로7길 15,64,57,61,182,61
2179,숙박,혼디,제주특별자치도 제주시 애월읍 신엄안3길 20,60,67,56,183,61
1768,숙박,언덕위에 빨간지붕,제주특별자치도 서귀포시 성산읍 난고로499번길 17,67,67,49,183,61
1402,숙박,더클라우드호텔,제주특별자치도 서귀포시 성산읍 한도로 269-37,60,71,53,184,61
11,관광지,THE WE,제주특별자치도 서귀포시 1100로 453-95,56,67,61,184,61
1573,숙박,베니키아 아이진호텔,제주특별자치도 제주시 신대로22길 4 (연동),71,66,46,183,61
2165,숙박,호텔 스카브로,제주특별자치도 서귀포시 예래해안로 15,63,60,61,184,61
2788,음식점,베이비카페 어놀,제주특별자치도 제주시 남광로2길 49-27 (이도이동),73,50,59,182,61
1651,숙박,성산아침노을펜션,제주특별자치도 서귀포시 성산읍 한도로255번길 14-1,72,53,58,183,61
1974,숙박,중문스테이,제주툭별자치도 서귀포시 중문관광로 288,73,59,51,183,61
3611,음식점,카페제주동네,제주특별자치도 제주시 구좌읍 종달로5길 23,55,66,61,182,61
1664,숙박,소소게스트하우스,제주특별자치도 제주시 애월읍 소길남길 190-18,60,56,63,179,60
3451,음식점,제주토속,제주특별자치도 제주시 동광로1길 27-1,94,41,45,180,60
2316,음식점,금능샌드,제주특별자치도 제주시 한림읍 금능길 89,57,58,66,181,60
2967,음식점,성산해녀짬뽕,제주특별자치도 서귀포시 성산읍 일출로 286,62,70,47,179,60
2293,음식점,국시트멍,제주특별자치도 제주시 진군길 31-3,73,59,49,181,60
1082,관광지,현의합장묘역,제주특별자치도 서귀포시 남원읍 중산간동로 6242-56,67,60,54,181,60
3602,음식점,카페쉼표,제주특별자치도 제주시 한림읍 한림로 359,62,57,62,181,60
3355,음식점,일품순두부 하귀점,제주특별자치도 제주시 애월읍 하귀9길 18,75,64,42,181,60
1731,숙박,아름다운리조트,제주특별자치도 서귀포시 성산읍 해맞이해안로 2644,51,50,78,179,60
1917,숙박,제주서울민박,제주특별자치도 서귀포시 남원읍 태위로 970,73,71,36,180,60
1560,숙박,발리인제주,제주도 제주시 구좌읍 달맞이해안로 2326,50,73,56,179,60
2962,음식점,성산 어멍횟집,제주특별자치도 서귀포시 성산읍 일출로 29,92,43,44,179,60
2369,음식점,넉둥베기 고사리육개장,제주특별자치도 제주시 용담1동 306-5,57,62,60,179,60
418,관광지,삼양방파제,제주특별자치도 제주시 벌랑길,75,51,54,180,60
2463,음식점,도나토스,제주특별자치도 제주시 한림읍 협재2길 6,64,62,54,180,60
2219,음식점,가시식당,제주특별자치도 서귀포시 표선면 가시로 565번길 24,51,68,60,179,60
3145,음식점,어멍횟집,제주특별자치도 서귀포시 성산읍 동류암로39번길 9-2,73,59,49,181,60
2783,음식점,버거307 협재점,제주특별자치도 제주시 한림읍 한림로 330,65,53,63,181,60
2221,음식점,가야아구찜,제주특별자치도 제주시 도공로 20 (도두1동) 1층 가야아구찜,61,61,59,181,60
2489,음식점,돌섬,제주특별자치도 서귀포시 성산읍 한도로 109,56,52,71,179,60
3434,음식점,제주오일장반점 제주신화월드점,제주특별자치도 서귀포시 안덕면 녹차분재로 217,82,56,43,181,60
1941,숙박,제주인호텔,제주특별자치도 제주시 신산마을길 20,53,70,57,180,60
2633,음식점,망고레이 함덕점,제주특별자치도 제주시 조천읍 조함해안로 504,53,63,63,179,60
2571,음식점,루스트플레이스 외도점,제주특별자치도 제주시 우정로 80,51,64,66,181,60
554,관광지,신양항(하추자항),제주특별자치도 제주시 추자면 신양리,61,67,51,179,60
1993,숙박,초원게스트하우스,제주특별자치도 제주시 우도면 우도로 225,69,65,46,180,60
1893,숙박,제주돌집2호점 (스코리아),제주특별자치도 제주시 구좌읍 김녕로1길 78,63,74,44,181,60
3459,음식점,제주흑돈세상수라간,제주특별자치도 서귀포시 중산간동로 8051,79,55,46,180,60
273,관광지,모지오름,제주특별자치도 서귀포시 표선면 성읍리 산 22,69,54,56,179,60
2034,숙박,탱자탱자게스트하우스,제주특별자치도 제주시 애월읍 애월로9길 69,70,75,36,181,60
2227,음식점,감나무집,제주특별자치도 제주시 오남로 12,62,66,51,179,60
3547,음식점,촐리케이크,제주특별자치도 제주시 신설로2길 1-1,74,58,44,176,59
1251,숙박,JK라마다앙코르 제주연동호텔,제주특별자치도 제주시 도령로 124,55,76,47,178,59
1522,숙박,물돌이민박,제주특별자치도 제주시 추자면 추자로 561,40,67,69,176,59
693,관광지,웃세오름(누운오름),제주특별자치도 제주시 애월읍 1100로 1579-25,60,54,62,176,59
2016,숙박,코즈게스트하우스,제주특별자치도 서귀포시 안덕면 동광로100번길 20 (동광리) 코즈게스트하우스,51,71,56,178,59
3519,음식점,창천삼거리식당,제주특별자치도 서귀포시 안덕면 일주서로 1332,71,49,57,177,59
3597,음식점,카페선흘,제주특별자치도 제주시 조천읍 선교로 198,65,56,55,176,59
2347,음식점,나나이로 아코제주,제주특별자치도 제주시 구좌읍 구좌로 75-1,52,57,67,176,59
3723,음식점,피시야 카페,제주특별자치도 제주시 조천읍 조함해안로 582,64,62,50,176,59
3147,음식점,어부와농부,제주특별자치도 서귀포시 천제연로 89,59,61,57,177,59
1793,숙박,여정여관,제주특별자치도 제주시 추자면 추자로 4-1,59,63,56,178,59
1373,숙박,다인리조트,제주특별자치도 제주시 애월읍 애월해안로 400-9 (고내리) 다인리조트,44,71,61,176,59
692,관광지,"웃밤(웃바매기,웃밤오름)",제주특별자치도 제주시 조천읍 선흘리 산 84,66,58,54,178,59
3615,음식점,카페태희,제주특별자치도 제주시 애월읍 곽지3길 27,68,52,58,178,59
3589,음식점,카페리(CAFERI),제주 제주시 구좌읍 평대2길 39,58,61,58,177,59
2190,숙박,흰수염고래리조트,제주특별자치도 제주시 애월읍 일주서로 6818,50,58,68,176,59
2751,음식점,바당봉봉,제주 제주시 구좌읍 해맞이해안로 1170,47,62,67,176,59
2746,음식점,바다의집,제주특별자치도 서귀포시 성산읍 해맞이해안로 2758,62,67,47,176,59
3820,음식점,혜자분식,제주특별자치도 제주시 다랑곶길 5,53,73,52,178,59
1419,숙박,동박생이,제주특별자치도 제주시 구좌읍 월정1길 89,42,68,67,177,59
3413,음식점,제주명가두루치기,제주특별자치도 서귀포시 태평로 495 (동홍동),59,58,60,177,59
2554,음식점,로뎀가든,제주특별자치도 제주시 우도면 우도해안길 264,50,67,60,177,59
1353,숙박,놀멍쉬멍고르멍,제주특별자치도 제주시 구좌읍 동복남4길 5-4,67,63,47,177,59
3025,음식점,순정문어,제주특별자치도 제주시 서해안로 579,65,62,51,178,59
2610,음식점,마틸다,제주특별자치도 제주시 애월읍 고내1길 33,76,52,48,176,59
3658,음식점,타무라,제주특별자치도 제주시 조천읍 중산간동로 670,52,66,58,176,59
2564,음식점,루스트플레이스 노형점,제주특별자치도 제주시 수덕로 79,49,55,73,177,59
2447,음식점,더로맨틱,제주특별자치도 제주시 조천읍 교래1길 26,57,63,57,177,59
1551,숙박,바닷가하우스펜션,제주특별자치도 서귀포시 대정읍 형제해안로 254,54,60,62,176,59
649,관광지,오림반,제주특별자치도 서귀포시 남원읍 신례리,69,67,42,178,59
923,관광지,중문리 신사터,제주특별자치도 서귀포시 천제연로 149,66,63,49,178,59
1140,쇼핑,라이킷,제주특별자치도 제주시 칠성로길 42-2 1층,60,67,51,178,59
2926,음식점,서광춘희,제주특별자치도 서귀포시 안덕면 화순서동로 367,68,65,43,176,59
3641,음식점,코코리파이프,제주특별자치도 제주시 애월읍 하귀6길 22,60,65,51,176,59
270,관광지,모라이,제주특별자치도 서귀포시 산록남로 (색달동),58,63,55,176,59
3650,음식점,큰돈가 본점,제주특별자치도 서귀포시 대정읍 형제해안로 296,68,53,56,177,59
1154,쇼핑,베리제주,제주특별자치도 제주시 애월읍 고내로7길 45-14,59,62,55,176,59
1800,숙박,예촌민박,서귀포시 남원읍 중산간동로 7126,47,65,63,175,58
910,관광지,족은사슴이오름,제주특별자치도 서귀포시 표선면 녹산로 536,79,46,50,175,58
1971,숙박,종달스토리,제주특별자치도 제주시 구좌읍 종달논길 61-7,57,57,59,173,58
1280,숙박,게으르게,제주특별자치도 제주시 조천읍 신북로 410,59,58,56,173,58
3479,음식점,중문수원음식점,제주특별자치도 서귀포시 천제연로 83,57,58,59,174,58
3484,음식점,중문해물라면오빠네,제주특별자치도 서귀포시 일주서로 962,79,52,44,175,58
1862,숙박,일레인호텔,"660, Iljuseo-ro, Seogwipo-si, Jeju-do",52,69,52,173,58
1581,숙박,별장민박,제주특별자치도 제주시 추자면 대서1길 9-6,53,59,63,175,58
1533,숙박,민박집섶낭,제주특별자치도 제주시 한림읍 협재2길 41,60,52,63,175,58
3026,음식점,순천미향,제주특별자치도 서귀포시 안덕면 사계남로216번길 24-73,74,59,41,174,58
2107,숙박,하마다 게스트하우스,제주특별자치도 서귀포시 남원읍 일주동로 6863,66,62,47,175,58
18,관광지,가문이오름(감은이오름),제주특별자치도 서귀포시 표선면 남조로 1487-73,65,56,54,175,58
430,관광지,새시물,제주특별자치도 제주시 한림읍 상한로,59,66,50,175,58
3776,음식점,함덕쉼팡,제주특별자치도 제주시 조천읍 조함해안로 584,47,76,50,173,58
594,관광지,"안세미 (명도오름,明道岳)",제주특별자치도 제주시 번영로 940,64,51,60,175,58
2661,음식점,명물,제주특별자치도 제주시 탑동로11길 2-1,70,47,58,175,58
1309,숙박,기분좋은 민박,제주특별자치도 제주시 구좌읍 선유로 36,56,70,49,175,58
1246,숙박,CS빌리지,제주특별자치도 제주시 애월읍 애월해안로 532-7,63,59,53,175,58
2492,음식점,돌카롱 애월점,제주특별자치도 제주시 애월읍 금성5길 44-9,67,58,49,174,58
3107,음식점,안녕육지사람,제주특별자치도 제주시 우도면 우도해안길 792,55,66,52,173,58
3855,음식점,흑돼지킹생구이전문점,제주특별자치도 제주시 도령로11길 26-9,70,53,50,173,58
1525,숙박,미도호스텔,제주특별자치도 서귀포시 동문동로 13-1,54,64,55,173,58
1472,숙박,로그밸리,제주특별자치도 제주시 애월읍 소길남길 190-19,53,62,60,175,58
1983,숙박,징크호텔,제주특별자치도 서귀포시 중정로 11,116,58,0,174,58
2652,음식점,메콩스카이,제주특별자치도 제주시 연오로 35,62,62,49,173,58
2869,음식점,빌레왓,제주특별자치도 서귀포시 안덕면 화순서동로 14,63,60,50,173,58
3477,음식점,중문솥뚜껑,제주특별자치도 서귀포시 이어도로 81,75,46,49,170,57
1007,관광지,팀케이,제주특별자치도 제주시 조천읍 북촌13길 23,52,62,58,172,57
1289,숙박,곰씨비씨게스트하우스,제주특별자치도 서귀포시 안덕면 난드르로21번길 13-7,54,70,47,171,57
2989,음식점,소반,제주특별자치도 서귀포시 중동로 23,58,55,57,170,57
359,관광지,북오름,제주특별자치도 서귀포시 안덕면 동광리 산 94,63,63,45,171,57
3331,음식점,이스트포레스트,제주특별자치도 제주시 구좌읍 종달로1길 26-1,69,58,44,171,57
3485,음식점,중식당 청,제주특별자치도 제주시 노연로 80 메종글래드 제주,60,67,45,172,57
2386,음식점,뉴저지카페,제주특별자치도 제주시 한경면 녹차분재로 567-5,69,49,54,172,57
1780,숙박,에코힐링하우스,제주특별자치도 제주시 한림읍 협재남2길 45-60 (협재리),61,71,39,171,57
2448,음식점,더비치하우스,제주특별자치도 서귀포시 성산읍 신양로122번길 17,47,59,64,170,57
3386,음식점,제라한보쌈,제주특별자치도 제주시 정존1길 33,54,55,63,172,57
544,관광지,신대산전망대,제주특별자치도 제주시 추자면 예초리,55,73,44,172,57
3184,음식점,영해식당 (제주점),제주특별자치도 제주시 정든로2길 24-1,57,55,59,171,57
3015,음식점,수카사,제주특별자치도 제주시 구좌읍 행원로9길 11,54,60,58,172,57
1596,숙박,브라운캐빈,제주특별자치도 제주시 애월읍 소길남길 190-40,52,76,43,171,57
1484,숙박,루체빌,제주특별자치도 서귀포시 안덕면 산록남로 786,51,66,55,172,57
3677,음식점,털보네 장원랜드,제주특별자치도 제주시 1100로 3001,53,68,51,172,57
1654,숙박,세화리움,제주특별자치도 제주시 구좌읍 해녀박물관길 29,59,69,42,170,57
2945,음식점,선미식당,제주특별자치도 서귀포시 성산읍 일출로 281,64,58,50,172,57
3800,음식점,햇살가득돌담집,제주특별자치도 제주시 조천읍 함대로 25-1,64,53,53,170,57
2482,음식점,돈이랑 서귀포점,제주특별자치도 서귀포시 중문관광로 321,50,51,70,171,57
1316,숙박,꽃머채 펜션,제주특별자치도 제주시 애월읍 소길남길 202-4,59,56,57,172,57
3000,음식점,송악산 엉클스 화덕 피자,제주특별자치도 서귀포시 대정읍 송악관광로 392,52,69,51,172,57
1934,숙박,제주올레돔,제주특별자치도 서귀포시 성산읍 온평포구로54번길 54,45,57,69,171,57
1459,숙박,라포즈,제주특별자치도 서귀포시 중산간서로 459,48,76,47,171,57
3140,음식점,어머니몸국,제주특별자치도 제주시 조천읍 신북로 245,53,58,60,171,57
2243,음식점,겹겹의 의도,제주특별자치도 서귀포시 홍중로27번길 4,55,58,58,171,57
2999,음식점,송당나무,제주특별자치도 제주시 구좌읍 송당5길 68-140,53,61,58,172,57
3836,음식점,황금손가락,제주특별자치도 제주시 구남동1길 44,51,59,61,171,57
3374,음식점,전설의마녀,제주특별자치도 제주시 애월읍 애월해안로 715,54,57,60,171,57
1250,숙박,JJ하우스,제주도 서귀포시 중산간서로 241,63,62,46,171,57
1253,숙박,UTS제주골프빌리지,제주도 제주시 애월읍 광령평화2길 170-2,75,53,44,172,57
2315,음식점,금강민물장어,제주특별자치도 서귀포시 일주동로 8597,64,62,44,170,57
140,관광지,남문지못,제주특별자치도 서귀포시 대정읍 인성리 392,57,56,57,170,57
2655,음식점,면사무소,제주특별자치도 제주시 애월읍 애월해안로 494,49,60,61,170,57
2172,숙박,호텔레오,제주특별자치도 제주시 삼무로 14,50,68,53,171,57
2061,숙박,펄리플러스,제주특별자치도 제주시 도두봉 2길 2,53,59,60,172,57
3671,음식점,탕궁훠궈,제주특별자치도 제주시 은남2길 41,65,52,52,169,56
2038,숙박,토마토하우스,제주특별자치도 서귀포시 성산읍 성산등용로 96-7,55,67,46,168,56
3299,음식점,월척수산,제주특별자치도 제주시 동한두기길 42-1,56,46,67,169,56
3598,음식점,카페세렌디,제주특별자치도 서귀포시 중문관광로72번길 29-9 라동 카페세렌디,53,61,53,167,56
3606,음식점,카페오름,제주특별자치도 서귀포시 성산읍 삼달로 128,60,52,56,168,56
2624,음식점,만월당,제주특별자치도 제주시 구좌읍 월정1길 56,46,44,78,168,56
2854,음식점,블리케이크,제주특별자치도 제주시 신설로6길 8 1층,59,53,55,167,56
2680,음식점,모시란,제주특별자치도 제주시 남광로 117-1,56,62,49,167,56
2425,음식점,당케올레국수,제주특별자치도 서귀포시 표선면 표선당포로 4,58,61,48,167,56
3072,음식점,신의한모,제주특별자치도 제주시 애월읍 하귀14길 11-1,71,47,49,167,56
973,관광지,추자연도교,제주특별자치도 제주시 추자면 영흥리 97-3,50,63,55,168,56
2698,음식점,무인카페 산책,제주특별자치도 제주시 애월읍 고내로7길 49,42,66,60,168,56
2314,음식점,글라글라하와이,제주특별자치도 서귀포시 대정읍 하모항구로 70,54,60,54,168,56
1313,숙박,김녕한옥 용암정원,제주특별자치도 제주시 구좌읍 김녕로19길 42-6,54,58,57,169,56
1485,숙박,루하우스,제주특별자치도 서귀포시 표선면 민속해안로119번길 8,50,54,63,167,56
1598,숙박,브릭216,제주특별자치도 서귀포시 이어도로 216,45,67,57,169,56
1455,숙박,라온호텔앤리조트,제주특별자치도 제주시 한림읍 금능남로 127,54,62,53,169,56
3699,음식점,파파야 수제버거,서귀포시 성산읍 성산등용로 7,48,61,58,167,56
2159,숙박,협재해오름펜션,제주특별자치도 제주시 한림읍 옹포2길 37-28 (옹포리) 협재해오름펜션,53,67,48,168,56
1595,숙박,브라운 스위트 제주 호텔 & 리조트,제주특별자치도 서귀포시 성산읍 고성오조로 94,50,71,48,169,56
3753,음식점,한라네 김밥,제주특별자치도 서귀포시 일주동로 8697,83,39,45,167,56
3710,음식점,포도호텔레스토랑,제주특별자치도 서귀포시 안덕면 산록남로 863,75,50,44,169,56
1975,숙박,중문진실캠핑장,제주특별자치도 서귀포시 천제연로 130,53,64,52,169,56
2346,음식점,나까무라,제주특별자치도 제주시 중앙로 214,55,62,52,169,56
3031,음식점,숨비나리,제주특별자치도 서귀포시 안덕면 중산간서로1615번길 8,54,52,63,169,56
1335,숙박,나바론 민박,제주특별자치도 제주시 추자면 추자로 76-1,45,71,51,167,56
1966,숙박,제주휴리조트,제주특별자치도 서귀포시 성산읍 난고로 230,51,65,53,169,56
3830,음식점,화로향,제주특별자치도 제주시 관덕로15길 27,48,58,63,169,56
1847,숙박,유월그리고열두마루,제주특별자치도 제주시 구좌읍 한동로1길 38,62,70,36,168,56
3660,음식점,타임스탬프,제주특별자치도 제주시 조천읍 신북로 92-1 1층,68,52,49,169,56
2119,숙박,한라궁,제주특별자치도 서귀포시 정방연로 6,49,65,53,167,56
2891,음식점,산방산초가집,제주특별자치도 서귀포시 안덕면 화순해안로 189,60,62,45,167,56
3245,음식점,용담밭담,제주특별자치도 제주시 서천길 16,69,55,43,167,56
2337,음식점,깡촌흑돼지,제주특별자치도 제주시 조천읍 함덕14길 2,72,56,41,169,56
415,관광지,삼사석,제주특별자치도 제주시 화북1동 1380-1,60,58,49,167,56
2946,음식점,선흘곶,제주특별자치도 제주시 조천읍 동백로 102,58,60,49,167,56
1083,관광지,협자연대,제주특별자치도 서귀포시 성산읍 고성리 57-1,59,58,50,167,56
1442,숙박,뚜르드제주게스트하우스,제주 제주시 구좌읍 종달로1길 38-2,59,60,49,168,56
3100,음식점,아일랜드조르바,제주특별자치도 제주시 구좌읍 대수길 9,53,62,49,164,55
2437,음식점,대원가,제주특별자치도 제주시 도남로16길 15,55,59,52,166,55
1148,쇼핑,"미야즈클로젯 (해녀복 대여, 해녀 스냅사진 촬영)",제주특별자치도 제주시 용마로4길 15,79,39,46,164,55
222,관광지,동알오름,제주특별자치도 서귀포시 대정읍 상모리 153,59,57,50,166,55
3168,음식점,엘리펀시아,제주특별자치도 제주시 1100로 3124,47,62,55,164,55
1584,숙박,보리게스트하우스,제주특별자치도 제주시 구좌읍 송당6길 38-1,49,58,58,165,55
1579,숙박,별똥별채집소,제주특별자치도 제주시 구좌읍 하도13길 51-1,57,53,56,166,55
1482,숙박,루시드봉봉,제주특별자치도 서귀포시 대정읍 상모로 200-8,63,57,45,165,55
1524,숙박,미도모텔,제주특별자치도 서귀포시 성산읍 성산등용로 1,60,55,50,165,55
2156,숙박,헤리티지,제주특별자치도 제주시 애월읍 하광로 530,54,55,56,165,55
1773,숙박,에리두 Cafe n Beds,제주특별자치도 서귀포시 대포복개로 37,46,65,53,164,55
1266,숙박,가파도상동펜션,제주특별자치도 서귀포시 대정읍 가파로 255,66,53,45,164,55
1570,숙박,범섬풍경,제주특별자치도 서귀포시 속골로 26,54,53,59,166,55
3601,음식점,카페숑,제주특별자치도 서귀포시 남원읍 공천포로 91,61,56,47,164,55
3009,음식점,수모루국수,제주특별자치도 서귀포시 일주동로 9057,55,53,57,165,55
3381,음식점,제갈양 제주협재점,제주특별자치도 제주시 한림읍 한림로 155,69,47,48,164,55
3617,음식점,카페피크닉(르피크닉),제주특별자치도 서귀포시 안덕면 대평로 39,50,52,62,164,55
1465,숙박,레드우드하우스,제주특별자치도 제주시 구좌읍 종달로1길 62,60,58,47,165,55
3185,음식점,예산가마솥장수촌설렁탕,제주특별자치도 제주시 구남동8길 53,67,65,34,166,55
2226,음식점,갈치 카페,제주 서귀포시 중문관광로 31,51,65,48,164,55
1935,숙박,제주올레하우스팬션,제주특별자치도 제주시 구좌읍 덕행로 450-23,74,59,32,165,55
3526,음식점,천리식당,제주특별자치도 제주시 구좌읍 송당6길 30,75,47,44,166,55
3554,음식점,춘미향 식당,제주특별자치도 서귀포시 안덕면 산방로 382,67,53,45,165,55
2542,음식점,라지마할 RAJMAHAL,제주특별자치도 제주시 신광로 39,52,56,57,165,55
2908,음식점,삼바리회센타,제주특별자치도 제주시 도남로7길 35,70,52,44,166,55
1208,쇼핑,제주i,제주특별자치도 서귀포시 성산읍 일출로288번길 8,48,66,52,166,55
2513,음식점,돼지굽는정원,제주특별자치도 제주시 한림읍 협재2길 8-7,49,60,55,164,55
2501,음식점,동글이흑돼지바베큐,제주특별자치도 서귀포시 천지로 2,63,53,49,165,55
3544,음식점,초밥군커피씨,제주특별자치도 제주시 흥운길 46,55,60,51,166,55
1956,숙박,제주펜션향림원,제주특별자치도 서귀포시 칠십리로394번길 8-3,61,52,52,165,55
1964,숙박,제주해안휴양펜션(제주해안펜션),제주특별자치도 서귀포시 안덕면 사계남로 89,42,58,65,165,55
2070,숙박,편운산장,제주도 서귀포시 성산읍 서성일로 898-38,58,58,45,161,54
1468,숙박,레이크힐스 제주 리조트,제주특별자치도 서귀포시 존제로 24,60,55,46,161,54
3263,음식점,우도해녀식당,제주특별자치도 제주시 우도면 우도해안길 440,53,56,52,161,54
2755,음식점,바람벽에흰당나귀,제주특별자치도 제주시 구좌읍 동복로 11,63,61,38,162,54
869,관광지,제주쥬티클럽,제주특별자치도 서귀포시 성산읍 신양로 113,42,55,65,162,54
1210,쇼핑,제주그림,제주특별자치도 서귀포시 효돈로 94,41,67,55,163,54
1702,숙박,신강남모텔,제주특별자치도 제주시 서광로3길 2,56,56,50,162,54
3111,음식점,안트레,제주특별자치도 제주시 애월읍 애월로 11,54,55,54,163,54
1763,숙박,야스라기펜션,제주특별자치도 제주시 애월읍 상귀서길 82-34,52,58,52,162,54
2095,숙박,하늘만큼땅만큼,제주특별자치도 제주시 애월읍 가문동상4길 5,45,53,65,163,54
645,관광지,예초리해변,제주특별자치도 제주시 추자면 예초리,58,58,47,163,54
318,관광지,발이오름,제주특별자치도 제주시 애월읍 어음리 산 1,67,52,42,161,54
2459,음식점,델리지아레스토랑,"제주특별자치도 서귀포시 중문관광로 224 제주국제컨벤션센터 3F,4F",68,46,48,162,54
35,관광지,개오리오름,제주특별자치도 제주시 봉개동,62,52,48,162,54
1577,숙박,베이힐 풀앤빌라,제주특별자치도 서귀포시 예래로 424,50,59,52,161,54
1301,숙박,그린트리인서귀포호텔,제주특별자치도 서귀포시 서호중앙로 84 (서호동) 그린트리 인 서귀포호텔,58,53,50,161,54
347,관광지,"보롬이(하논, 화구구)",제주특별자치도 서귀포시 하논로 (서홍동),57,61,45,163,54
3270,음식점,우림일식,제주특별자치도 제주시 도령로 28-2,55,51,57,163,54
2769,음식점,박장군,서귀포시 안덕면 중산간서로 2120,50,59,54,163,54
1160,쇼핑,사슴책방,제주특별자치도 제주시 조천읍 중산간동로 698-71,52,58,51,161,54
2637,음식점,망고홀릭 제주본점,제주 제주시 삼무로5길 2,58,51,54,163,54
2268,음식점,골막식당,제주특별자치도 제주시 천수로 12,53,66,42,161,54
3019,음식점,순덕이네해산물장터,제주특별자치도 서귀포시 성산읍 온평서로 48,64,46,52,162,54
1895,숙박,제주락,제주특별자치도 서귀포시 월드컵로 203,53,52,56,161,54
2551,음식점,레이지박스,제주특별자치도 서귀포시 안덕면 산방로 208,49,57,56,162,54
909,관광지,족은바리메,제주특별자치도 제주시 애월읍 상가리 산 124,54,55,52,161,54
1875,숙박,제주 리치호텔,제주특별자치도 제주시 애월읍 고내로13길 100,46,60,57,163,54
3095,음식점,아서원,서귀포시 일주동로 8143,53,48,61,162,54
354,관광지,봉글레산,제주특별자치도 제주시 추자면 대서5길 1,67,55,41,163,54
1657,숙박,소낭게스트하우스,제주특별자치도 제주시 구좌읍 월정1길 1,49,63,51,163,54
3274,음식점,우수미회센타,제주특별자치도 제주시 연화로2길 24-1,57,62,44,163,54
2196,음식점,2093하우스,제주특별자치도 제주시 조천읍 남조로 2093,61,49,51,161,54
3164,음식점,에이스쌀국수,제주특별자치도 제주시 우정로5길 4,57,54,52,163,54
2359,음식점,남해횟집,제주특별자치도 제주시 국기중길 3,70,49,44,163,54
1449,숙박,라마다앙코르 서귀포호텔,제주특별자치도 서귀포시 서호중로 55,52,61,48,161,54
2212,음식점,jival 지발,제주특별자치도 제주시 애월읍 애월해안로 212,42,62,58,162,54
3532,음식점,철가방을든해녀,제주특별자치도 서귀포시 대정읍 마라로 85,57,53,53,163,54
1734,숙박,아림민박,제주특별자치도 제주시 서해안로 456-8,55,46,62,163,54
3151,음식점,어우늘,제주특별자치도 제주시 연북로 222,45,56,60,161,54
2115,숙박,하이디펜션,제주특별자치도 서귀포시 안덕면 사계북로41번길 142 (사계리) 하이디펜션,50,72,39,161,54
3135,음식점,얌얌돈까스,제주특별자치도 제주시 구좌읍 구좌로 44,60,58,44,162,54
1662,숙박,소랑호젠,제주특별자치도 서귀포시 남원읍 태위로 545,51,64,47,162,54
1339,숙박,난드르통나무집,제주특별자치도 서귀포시 안덕면 대평로 36,48,61,53,162,54
1326,숙박,나무사이로햇살이,제주특별자치도 제주시 구좌읍 중산간동로 2281,60,59,42,161,54
1332,숙박,나무처럼 게스트하우스,제주시 한림읍 홍수암로 3-1,43,58,59,160,53
1988,숙박,청춘게스트하우스,제주특별자치도 서귀포시 색달중앙로 22,53,58,48,159,53
3408,음식점,제주돔베막국수,제주특별자치도 제주시 한경면 고산로 35,50,68,42,160,53
3845,음식점,효섬마을초가집,제주특별자치도 제주시 명림로 243,48,61,50,159,53
3492,음식점,지붕위제주바다,제주특별자치도 제주시 구좌읍 평대2길 17,56,50,54,160,53
2394,음식점,다가미(도남),제주특별자치도 제주시 도남로 111,55,59,44,158,53
286,관광지,묵리처녀당,제주특별자치도 제주시 추자면 묵리 229-1,69,49,40,158,53
1510,숙박,메종드오조락,제주특별자치도 서귀포시 성산읍 오조로 140,40,54,66,160,53
1933,숙박,제주오리엔탈호텔,제주특별자치도 제주시 탑동로 47,53,58,48,159,53
1608,숙박,블루펄,제주특별자치도 서귀포시 태평로92번길 35,48,48,63,159,53
3514,음식점,착한마녀김밥,제주 서귀포시 성산읍 고성오조로 64,63,45,51,159,53
139,관광지,남두연대,제주특별자치도 제주시 애월읍 신엄리 2780-1,56,43,61,160,53
3021,음식점,순심이네한라봉돼지갈비,제주특별자치도 서귀포시 안덕면 산방로 3,52,62,46,160,53
2986,음식점,소녀방앗간,제주특별자치도 서귀포시 중정로 22,62,46,52,160,53
1592,숙박,부영CC관광호텔,제주특별자치도 서귀포시 남원읍 남조로 960,58,55,45,158,53
3575,음식점,카페 사우다드,제주특별자치도 서귀포시 대정읍 하모이삼로51번길 28,52,59,48,159,53
2399,음식점,다래향,제주특별자치도 제주시 조천읍 조함해안로 428-4,52,61,45,158,53
1277,숙박,건축학개론펜션,제주특별자치도 서귀포시 성산읍 신풍하동로 224-33,50,62,47,159,53
308,관광지,민오름(조천읍),제주특별자치도 제주시 조천읍 선흘리 산 141,63,50,46,159,53
1670,숙박,솔바람풍경소리펜션,제주특별자치도 서귀포시 남원읍 태수로143번길 132-37,47,66,47,160,53
1928,숙박,제주야자원,제주특별자치도 서귀포시 표선면 풍천로273번길 143-13,62,42,56,160,53
3388,음식점,제리스펍,제주특별자치도 서귀포시 솔동산로 20,53,60,45,158,53
3725,음식점,피자굽는돌하르방,제주특별자치도 제주시 한경면 청수로 218,48,57,54,159,53
3259,음식점,우도이야기,제주특별자치도 제주시 우도면 우도해안길 504,49,62,47,158,53
2677,음식점,모메존,제주특별자치도 제주시 도두3길 17,65,49,46,160,53
210,관광지,돔박이오름 (동박악),제주특별자치도 서귀포시 안덕면 광평리 산 89,64,52,44,160,53
2558,음식점,로스터리카페 담담,제주시 한경면 저지12길 60,50,59,50,159,53
181,관광지,"대왕산 (왕뫼, 왕메, 왕미)",제주특별자치도 서귀포시 성산읍 수산리 1429,47,60,51,158,53
2662,음식점,명성식당,제주특별자치도 제주시 삼성로 94,62,53,43,158,53
3817,음식점,협재칼국수,제주특별자치도 제주시 한림읍 협재로 3,54,46,59,159,53
2713,음식점,미드나잇 제주,제주특별자치도 서귀포시 안덕면 신화역사로304번길 98,61,52,46,159,53
1676,숙박,수앤수가족호텔,제주시 애월읍 부룡수길 60,45,62,52,159,53
3814,음식점,협재삼춘네횟집,제주특별자치도 제주시 한림읍 한림로 318,49,49,61,159,53
2310,음식점,그릴데미그라스,제주특별자치도 서귀포시 월드컵로 51,50,51,57,158,53
3715,음식점,풀베개,제주특별자치도 서귀포시 안덕면 화순서서로 492-4,60,60,39,159,53
1715,숙박,썬비치리조트,제주특별자치도 제주시 서해안로 114,56,46,54,156,52
3784,음식점,해녀식당(동복리),제주특별자치도 제주시 구좌읍 동복로 5,52,55,49,156,52
3853,음식점,흑돼지신화,제주특별자치도 서귀포시 안덕면 한창로 628,58,54,43,155,52
1647,숙박,선샤인호텔,제주시 조천읍 신북로 481-9,48,62,46,156,52
2341,음식점,꽃가람,제주특별자치도 서귀포시 성산읍 고성동서로 73,51,48,58,157,52
2923,음식점,샤오츠,제주특별자치도 서귀포시 성산읍 성산등용로17번길 55,52,51,52,155,52
3578,음식점,카페3535.1,제주특별자치도 제주시 조천읍 함덕2길 82,60,55,41,156,52
3513,음식점,차이나마씸,제주특별자치도 서귀포시 칠십리로 474,59,48,50,157,52
2258,음식점,고불락,제주특별자치도 제주시 애월읍 고내로7길 45-12,55,52,50,157,52
2278,음식점,곽지식당,제주특별자치도 제주시 애월읍 곽지3길 27,44,53,59,156,52
3791,음식점,해성도뚜리,제주특별자치도 제주시 애월읍 애월해안로 682,51,48,56,155,52
2799,음식점,볕이드는곳벧디,제주특별자치도 제주시 은수길 65,57,53,45,155,52
3600,음식점,카페소금,제주특별자치도 제주시 애월읍 구엄길 96,63,38,54,155,52
1882,숙박,제주가온29,제주특별자치도 제주시 애월읍 중산간서로 5409,56,55,44,155,52
285,관광지,묵리마을,제주특별자치도 제주시 추자면 묵리,54,57,45,156,52
3511,음식점,차마실,제주특별자치도 제주시 애월읍 하귀동남1길 32-15,49,51,57,157,52
2647,음식점,메밀꽃차롱,제주특별자치도 제주시 연오로 136 (연동),60,50,46,156,52
2522,음식점,등경돌식당,제주특별자치도 서귀포시 성산읍 일출로 279,53,61,41,155,52
1566,숙박,백패커스홈,제주특별자치도 서귀포시 중정로 24,50,60,46,156,52
1437,숙박,디오션힐,제주특별자치도 서귀포시 안덕면 사계북로 208,46,51,59,156,52
699,관광지,월나봉(도래오름),제주특별자치도 서귀포시 안덕면 감산리 1148 일대,54,60,41,155,52
2794,음식점,벨롱,제주특별자치도 제주시 구좌읍 해맞이해안로 1652,47,64,44,155,52
2124,숙박,함덕산티아고게스트하우스,제주특별자치도 제주시 조천읍 신촌9길 47-2,47,52,57,156,52
2538,음식점,라스또르따스,"제주특별자치도 제주시 애월읍 애월해안로 274 , 1층",50,58,47,155,52
3334,음식점,이오리,제주특별자치도 제주시 도리로 53,48,55,52,155,52
3461,음식점,조가네갑오징어 신제주점,제주특별자치도 제주시 원노형남1길 45-1,51,60,46,157,52
3668,음식점,탑동산호전복,제주특별자치도 제주시 탑동로 59,60,48,47,155,52
2565,음식점,루스트플레이스 베라체점,제주특별자치도 제주시 승천로 73,43,56,56,155,52
3832,음식점,화진전복,제주특별자치도 제주시 무근성길 2,48,63,45,156,52
1398,숙박,더쉼팡스파&풀빌라,제주특별자치도 서귀포시 표선면 세성로 67-10,61,58,36,155,52
2163,숙박,호텔 리젠트마린,제주특별자치도 제주시 서부두2길 20,49,60,46,155,52
1673,숙박,쇠소깍올레민박,제주특별자치도 서귀포시 효돈로204번길 23,51,58,46,155,52
3508,음식점,차귀놀,제주특별자치도 제주시 한경면 한경해안로 136,53,60,44,157,52
3212,음식점,오복떡집,제주특별자치도 제주시 동문로2길 4,55,51,50,156,52
1851,숙박,이디하우스n카페,제주특별자치도 제주시 구좌읍 해녀박물관길 33-2,56,52,47,155,52
1134,쇼핑,동문시장(주),제주특별자치도 제주시 동문로 16,53,55,49,157,52
3822,음식점,호도제과,제주특별자치도 서귀포시 이어도로 923-1 호도제과,61,46,48,155,52
3377,음식점,정가네 밥상,제주특별자치도 제주시 아란서길 110,56,55,45,156,52
2430,음식점,대니스카페,제주특별자치도 제주시 우도면 우도해안길 1128,49,54,52,155,52
3127,음식점,애월리안,제주특별자치도 제주시 애월읍 애원로 4,58,48,51,157,52
2096,숙박,하늘을달리다,제주특별자치도 제주시 구좌읍 문주란로5길 25,36,67,53,156,52
1843,숙박,유니호텔제주,제주특별자치도 제주시 애월읍 애월해안로 656,53,49,54,156,52
3034,음식점,숲속의작은집,제주특별자치도 제주시 주르레길 63,33,50,70,153,51
3013,음식점,수월봉 가마솥순대국,제주특별자치도 제주시 한경면 고산서2길 18,54,55,44,153,51
2871,음식점,빠빠라기,제주특별자치도 제주시 신광로 45,45,52,57,154,51
3813,음식점,현옥식당,제주특별자치도 제주시 서광로2길 35(오라일동),53,52,48,153,51
1675,숙박,수상한집 광보네,제주특별자치도 제주시 도련3길 14-4 2층,35,74,45,154,51
2466,음식점,도도톳김밥,제주특별자치도 제주시 구좌읍 해맞이해안로 1460,64,37,52,153,51
2398,음식점,다람쥐 식탁,제주특별자치도 제주시 한림읍 명월성로 10,49,56,49,154,51
3674,음식점,탭룸3029,제주특별자치도 제주시 1100로 3029,48,55,50,153,51
3042,음식점,스시도모다찌 제주점,제주특별자치도 제주시 광양8길 1,53,51,49,153,51
3033,음식점,숨어있는집,제주특별자치도 제주시 조천읍 함덕로 24,48,52,53,153,51
1411,숙박,돈내코힐 리조트,제주특별자치도 서귀포시 돈내코로 180,49,49,55,153,51
1091,관광지,화북비석거리,제주특별자치도 제주시  화북1동 4008,60,48,45,153,51
2589,음식점,마더카페,제주특별자치도 서귀포시 남원읍 태위로894번길 45,47,55,50,152,51
3825,음식점,호박다방,제주특별자치도 제주시 애월읍 일주서로 6111,52,54,48,154,51
1648,숙박,선스토리,제주특별자치도 서귀포시 표선면 표선백사로60번길 72,47,55,51,153,51
3173,음식점,연동둘둘김밥,제주특별자치도 제주시 국기로 21,67,58,28,153,51
3543,음식점,체면,제주특별자치도 서귀포시 대정읍 인안성로 23-1,48,53,53,154,51
1839,숙박,월정플레이스,제주특별자치도 제주시 구좌읍 월정1길 54-34,49,60,43,152,51
3541,음식점,청해원,제주특별자치도 제주시 원노형남1길 44,38,42,74,154,51
2417,음식점,달사막,제주특별자치도 제주시 조천읍 함덕로 26,61,44,48,153,51
3504,음식점,짬뽕에취한날,제주특별자치도 제주시 귀아랑2길 4,55,50,48,153,51
2922,음식점,샤라의정원,제주특별자치도 제주시 조천읍 선교로 198-2,56,57,41,154,51
3713,음식점,포트그릴 스테이크하우스,제주특별자치도 서귀포시 솔동산로10번길 48,55,51,46,152,51
3178,음식점,연정식당,제주특별자치도 제주시 신광로10길 29,52,58,43,153,51
230,관광지,등머을레져,제주특별자치도 제주시 우도면 우도해안길 70,59,39,55,153,51
879,관광지,제주펫,제주특별자치도 서귀포시 남원읍 한신로531번길 22-3,61,52,41,154,51
1548,숙박,바다해호텔,제주특별자치도 서귀포시 천지연로 3-1,48,60,45,153,51
3599,음식점,카페세바,제주특별자치도 제주시 조천읍 선흘동2길 20-7,50,46,57,153,51
3074,음식점,신촌덕인당,제주특별자치도 제주시 조천읍 신북로 36,51,53,50,154,51
2599,음식점,마린보이횟집,제주특별자치도 제주시 어영길 10,65,56,33,154,51
3521,음식점,창흥식당,제주특별자치도 제주시 조천읍 함덕16길 15,50,53,50,153,51
1781,숙박,에쿠스모텔,제주특별자치도 서귀포시 안덕면 화순중앙로54번길 5,61,50,42,153,51
2335,음식점,까미노,제주특별자치도 제주시 애월읍 고하상로 91-12,44,54,55,153,51
943,관광지,참굴비조형물,제주특별자치도 제주시 추자면 묵리 산 131-1,60,50,42,152,51
2279,음식점,광원,제주특별자치도 제주시 1100로 3208,46,58,49,153,51
503,관광지,소병악 (족은오름),제주특별자치도 서귀포시 안덕면 상창리 산 2-1,53,52,47,152,51
2164,숙박,호텔 샬롬제주,제주특별자치도 제주시 동광로 34,58,53,42,153,51
1791,숙박,여래게스트하우스,제주특별자치도 제주시 구좌읍 세화7길 31-2,59,45,50,154,51
2845,음식점,브릭스 제주,제주특별자치도 제주시 구좌읍 김녕로2길 6,48,47,55,150,50
2069,숙박,펠리시아호텔,제주특별자치도 서귀포시 일주동로 9123,46,62,41,149,50
1783,숙박,엔젤하우스,제주특별자치도 제주시 애월읍 신엄안3길 95,53,50,47,150,50
2702,음식점,문쏘,제주특별자치도 제주시 한림읍 한림상로 15-5,40,60,51,151,50
1290,숙박,공감민박,제주특별자치도 서귀포시 성산읍 수산서남로 75,40,55,56,151,50
2441,음식점,대포횟집,제주특별자치도 서귀포시 대포로 169 (대포동),50,54,47,151,50
2803,음식점,보룡제과,제주특별자치도 서귀포시 성산읍 고성오조로 48-1,52,53,44,149,50
3215,음식점,오조해녀의 집,제주특별자치도 서귀포시 성산읍 한도로 141-13,49,42,60,151,50
619,관광지,엄바위장승,제주특별자치도 제주시 추자면 예초리 332,51,54,46,151,50
1668,숙박,솔로 게스트하우스,제주특별자치도 서귀포시 대정읍 송악관광로411번길 11,47,60,42,149,50
3775,음식점,함덕밀면,제주특별자치도 제주시 조천읍 신북로 566,55,41,54,150,50
3536,음식점,청운식당,제주특별자치도 서귀포시 성산읍 일출로 285,52,52,46,150,50
1513,숙박,모물펜션,제주특별자치도 제주시 애월읍 곽지9길 4,58,49,43,150,50
1835,숙박,우연히 행복해지다,제주특별자치도 제주시 한림읍 한림로 224,43,41,66,150,50
1669,숙박,솔민박,제주특별자치도 서귀포시 표선면 민속해안로 227-39,55,57,39,151,50
3398,음식점,제주광어씨푸드레스토랑 표선점,제주특별자치도 서귀포시 표선면 표선당포로 7,52,55,42,149,50
1585,숙박,보물섬,제주특별자치도 서귀포시 성산읍 한도로242번길 10-11,41,56,54,151,50
2323,음식점,길벗식당,제주특별자치도 제주시 월광로 162,57,49,44,150,50
3827,음식점,홍돈깡통연탄구이,제주특별자치도 제주시 한림읍 한림로3길 10-12,59,48,42,149,50
2409,음식점,다해복국,제주특별자치도 제주시 문송1길 17 (연동),51,55,44,150,50
1471,숙박,로그맨하우스,제주특별자치도 제주시 애월읍 소길남길 179,47,63,39,149,50
2324,음식점,김녕제주흑돼지정육점식당,제주특별자치도 제주시 구좌읍 김녕로4길 28,57,37,57,151,50
2136,숙박,해변산책펜션,제주특별자치도 제주시 애월읍 곽지9길 7,51,56,44,151,50
1922,숙박,제주시드니호텔,제주특별자치도 제주시 애월읍 애월해안로 943,54,65,32,151,50
3265,음식점,우드노트,제주특별자치도 서귀포시 남원읍 태위로510번길 49,49,43,58,150,50
1271,숙박,개스트하우스 말2,제주특별자치도 서귀포시 안덕면 화순중앙로 93,49,56,46,151,50
2883,음식점,사우스바운더,제주특별자치도 서귀포시 예래로 33,46,56,49,151,50
1174,쇼핑,소소한담,제주특별자치도 제주시 애월읍 일주서로 6691,50,52,48,150,50
1925,숙박,제주아이니,제주특별자치도 서귀포시 남원읍 태위로894번길 20-30,55,91,4,150,50
2499,음식점,동구미,제주특별자치도 제주시 조천읍 중산간동로 929,42,63,44,149,50
2145,숙박,해오름민박,제주특별자치도 제주시 우도면 우도해안길 830,50,43,56,149,50
3286,음식점,원당골,제주특별자치도 제주시 원당로 72,47,53,50,150,50
1259,숙박,가까이에파도소리,제주도 제주시 외도2동 연대마을길 44,46,62,43,151,50
468,관광지,섬생이,제주특별자치도 제주시 추자면 신양리 산 87,51,56,43,150,50
2687,음식점,몬스터살롱,제주특별자치도 제주시 애월읍 일주서로 6017,44,57,49,150,50
1001,관광지,토산봉(망오름),제주특별자치도 서귀포시 표선면 토산리 산 13,54,49,46,149,50
2173,숙박,호텔빠레브,제주특별자치도 서귀포시 김정문화로 23,52,52,47,151,50
1200,쇼핑,윌로우씨  제주캔들공방,제주특별자치도 제주시 동문로 16 (일도1동) 동문시장(주) 2층 윌로우씨 제주 캔들공방,48,48,55,151,50
3609,음식점,카페이피엘,제주특별자치도 서귀포시 남원읍 위미항구로 8 (위미리) 카페이피엘,39,62,48,149,50
2991,음식점,소소희,제주특별자치도 서귀포시 대정읍 영어도시로 27-2,48,63,39,150,50
3497,음식점,진돼지,제주특별자치도 제주시 은수길 65,54,53,44,151,50
2560,음식점,로이앤메이,제주특별자치도 서귀포시 성산읍 온평상하로15번길 12-7,62,53,35,150,50
423,관광지,상추자마을길,제주특별자치도 제주시 추자도 추자면,60,51,38,149,50
3247,음식점,용두암 바당회국수,제주시 서해안로 614,71,45,35,151,50
3139,음식점,어머니닭집,제주특별자치도 서귀포시 성산읍 고성오조로 13,40,51,58,149,50
2996,음식점,솔트스톤,제주특별자치도 제주시 연삼로 495,48,61,41,150,50
2519,음식점,두툼한고기돈돼지,제주특별자치도 제주시 조천읍 함덕19길 3,52,43,54,149,50
2064,숙박,펜션머물다,제주특별자치도 서귀포시 논짓물로48번길 16-6,59,46,46,151,50
1492,숙박,마눌펜션,제주특별자치도 제주시 애월읍 고내봉서2길 73,55,41,55,151,50
1686,숙박,스머프하우스,제주특별자치도 서귀포시 천제연로 127-1,50,55,44,149,50
1453,숙박,라신비,제주특별자치도 제주시 한림읍 한림해안로 548,44,56,50,150,50
2354,음식점,난드르깡통구이,제주특별자치도 서귀포시 안덕면 대평감산로 14,43,64,43,150,50
1248,숙박,IGH펜션,제주시 한경면 금등3길 25,41,47,61,149,50
3298,음식점,월정해녀식당,제주특별자치도 제주시 구좌읍 해맞이해안로 434,46,63,42,151,50
2857,음식점,비브레이브커피로스터스,제주특별자치도 서귀포시 서호중앙로 85-13,61,43,46,150,50
2351,음식점,나무카페,제주특별자치도 제주시 조천읍 선교로 560,49,53,47,149,50
2232,음식점,강정해녀의집,제주특별자치도 서귀포시 말질로 290,49,53,48,150,50
1367,숙박,다래산장,제주특별자치도 제주시 애월읍 납읍로10길 49-32,54,56,41,151,50
1312,숙박,김녕몽생이,제주특별자치도 제주시 구좌읍 김녕로1길 35-14,42,48,56,146,49
1275,숙박,갯바위펜션,제주특별자치도 서귀포시 하예하동로 37,40,63,43,146,49
1562,숙박,방울풍뎅이 하우스,제주특별자치도 서귀포시 남원읍 위미중앙로 274-45,39,61,46,146,49
606,관광지,애월연대,제주특별자치도 제주시 애월읍 애월리 1975,62,45,41,148,49
1294,숙박,그라벨호텔제주,제주특별자치도 제주시 일주서로 7316,58,54,35,147,49
3182,음식점,영주말가든,제주특별자치도 제주시 연북로 196,38,56,54,148,49
2588,음식점,마님순대,제주시 정존15길 42,53,53,41,147,49
1633,숙박,사면초가펜션,제주특별자치도 제주시 한경면 판조로 62,45,46,57,148,49
1293,숙박,굿데이 펜션,제주특별자치도 서귀포시 남성로115번길 2,55,48,44,147,49
254,관광지,마오름(한경),제주특별자치도 제주시 한경면 저지리 산 56,49,58,40,147,49
1355,숙박,뉴그린모텔,제주특별자치도 서귀포시 표선면 표선백사로 119,36,55,55,146,49
3077,음식점,심바카레,제주특별자치도 제주시 애월읍 금성5길 44-16,51,44,53,148,49
3523,음식점,채훈이네해장국,제주특별자치도 제주시 한경면 두신로 69,54,45,48,147,49
1952,숙박,제주팔레스호텔,제주특별자치도 제주시 탑동로 9,56,53,37,146,49
3684,음식점,토담골,제주특별자치도 제주시 간월동로 5,40,55,53,148,49
1101,관광지,황우럭만화천국사회적협동조합,제주특별자치도 제주시 한림읍 내동남길 7-3,49,48,49,146,49
2184,숙박,황재여관,제주특별자치도 제주시 추자면 추자로 70,39,47,61,147,49
2517,음식점,두루두루,제주특별자치도 제주시 삼무로3길 14,55,42,51,148,49
1495,숙박,마라도게스트하우스,제주특별자치도 서귀포시 대정읍 마라로 73,54,55,38,147,49
1990,숙박,초,제주특별자치도 서귀포시 성산읍 풍천로27번길 33-3,38,56,53,147,49
3777,음식점,함덕찜,제주특별자치도 제주시 조천읍 함덕로 20,59,41,48,148,49
1591,숙박,부르네스테이,제주특별자치도 제주시 서해안로 376,50,53,44,147,49
1406,숙박,데이즈호텔 제주서귀포오션,제주특별자치도 서귀포시 동홍로 7,44,53,51,148,49
643,관광지,예초리기정길,제주특별자치도 제주시 추자면 예초리 산 1,48,63,37,148,49
2887,음식점,산굼부리카페,제주특별자치도 제주시 조천읍 비자림로 768,100,28,19,147,49
1709,숙박,신흥소시민,제주특별자치도 제주시 조천읍 신흥로1길 21,56,58,32,146,49
2696,음식점,무뚱 식도락 식당,제주특별자치도 서귀포시 남원읍 태위로689번길 10,54,43,49,146,49
3052,음식점,슬슬슬로우,제주특별자치도 제주시 구좌읍 행원로7길 23-8,50,48,49,147,49
876,관광지,제주컨트리클럽,제주특별자치도 제주시 영평동 2263-5,52,54,42,148,49
2251,음식점,고내촌한정식,제주특별자치도 제주시 애월읍 고내로13길 73,45,50,53,148,49
3565,음식점,칠돈가 표선직영점,제주특별자치도 서귀포시 표선면 표선당포로 13-1,52,42,52,146,49
2752,음식점,바당지기,제주특별자치도 제주시 구좌읍 월정7길 28-21,40,57,51,148,49
1370,숙박,다올제민박,제주특별자치도 제주시 구좌읍 하도7길 9,43,60,44,147,49
1931,숙박,제주엠리조트,제주특별자치도 서귀포시 중산간서로157번길 28-6,61,39,46,146,49
2334,음식점,까망돼지,제주특별자치도 서귀포시 색달중앙로 21,52,43,53,148,49
1707,숙박,신촌돌집,제주특별자치도 제주시 조천읍 신촌5길 30,61,53,33,147,49
3545,음식점,초승달지대,제주특별자치도 서귀포시 대청로25번길 10-8,54,54,38,146,49
3236,음식점,와랑와랑카페,제주특별자치도 서귀포시 남원읍 위미중앙로300번길 28,55,51,40,146,49
2988,음식점,소라횟집,제주특별자치도 제주시 구좌읍 해맞이해안로 1240-3,59,47,41,147,49
1126,쇼핑,달리센트,제주특별자치도 제주시 구좌읍 종달리 1991,38,52,57,147,49
2481,음식점,돈이랑,제주특별자치도 서귀포시 일주서로 953,40,50,57,147,49
3661,음식점,타코마씸,제주특별자치도 제주시 구좌읍 해맞이해안로 474,59,42,47,148,49
1739,숙박,아올키즈펜션,제주특별자치도 서귀포시 안덕면 사계중앙로 13-15,47,50,49,146,49
3254,음식점,우도돼지네 땅콩만두,서귀포시 중정로73번길 15-1,43,56,48,147,49
1559,숙박,발로바쉬,제주특별자치도 제주시 애월읍 일주서로 6066,39,48,59,146,49
3480,음식점,중문신라원,제주특별자치도 서귀포시 천제연로 107,50,54,41,145,48
3405,음식점,제주담,제주특별자치도 제주시 구좌읍 비자림로 1575,43,47,53,143,48
3449,음식점,제주콩순옥,제주특별자치도 서귀포시 대정읍 신영로 129-2,38,71,36,145,48
3679,음식점,텍시아,제주특별자치도 제주시 구좌읍 평대2길 39-28,38,51,55,144,48
1233,쇼핑,하나로마트 구좌농협 우도점,제주특별자치도 제주시 우도면 우도로 178,46,43,55,144,48
2082,숙박,푸르미르 펜션,제주특별자치도 서귀포시 성산읍 한도로 207,42,48,53,143,48
1283,숙박,고망난돌민박가든,제주특별자치도 서귀포시 성산읍 일주동로 5464,41,58,45,144,48
3023,음식점,순옥이네명가 함덕점,제주특별자치도 제주시 조천읍 함덕로 6,53,49,43,145,48
2807,음식점,보말이야기,제주특별자치도 제주시 한림읍 비양도길 14-3,35,40,68,143,48
1122,쇼핑,농업회사법인 나무와열매 주식회사,제주특별자치도 서귀포시 안덕면 덕수동로25번길 42-8,60,48,35,143,48
2433,음식점,대성아귀찜,제주특별자치도 제주시 조천읍 함덕3길 4,34,45,65,144,48
3732,음식점,하노이안브라더스,제주특별자치도 제주시 천수동로 1,50,50,45,145,48
1211,쇼핑,제주민속식품,제주특별자치도 제주시 구좌읍 번영로 2178,40,60,43,143,48
3390,음식점,제스피,제주특별자치도 제주시 신대로16길 44,51,48,45,144,48
202,관광지,도리미오름,제주특별자치도 제주시 구좌읍 송당리 산 255-1,56,45,42,143,48
3522,음식점,채점석베이커리,제주특별자치도 서귀포시 신서로32번길 12,51,45,48,144,48
1171,쇼핑,선우스타일,제주특별자치도 제주시 동문로 16,50,36,58,144,48
1769,숙박,엄블랑펜션,제주특별자치도 서귀포시 안덕면 형제해안로132번길 15-24,55,59,29,143,48
2434,음식점,대수길다방,제주특별자치도 제주시 구좌읍 대수길 24,41,53,50,144,48
2155,숙박,헌치 게스트하우스,제주특별자치도 제주시 구좌읍 비자림로 1627 (송당리) 제주 오석심 공예 명장관,47,49,47,143,48
1799,숙박,예이츠산장,서귀포시 남원읍 516로 918,46,55,42,143,48
2282,음식점,교래흑돼지,제주특별자치도 제주시 조천읍 교래4길 73,50,51,43,144,48
2824,음식점,봉끄랑,제주특별자치도 제주시 우도면 우도해안길 144,36,56,53,145,48
3605,음식점,카페앤드효은양갱,서귀포시 안덕면 덕수회관로 14,52,46,46,144,48
2714,음식점,미래뷔페정식,제주특별자치도 서귀포시 516로 200,57,46,40,143,48
2764,음식점,바온탑,"제주특별자치도 서귀포시 안덕면 신화역사로304번길 38, 신화관 제주신화월드 호텔 앤 리조트 1F 스카이풀 옆 바온탑",49,51,45,145,48
2707,음식점,물고기카페,제주특별자치도 서귀포시 안덕면 난드르로 25-7,38,56,50,144,48
2745,음식점,바다위에코끼리,제주특별자치도 제주시 한림읍 협재1길 27-6,42,53,50,145,48
1653,숙박,성산풀하우스,제주특별자치도 서귀포시 성산읍 환해장성로121번길 21-4,43,44,58,145,48
3801,음식점,행복맛집,제주특별자치도 제주시 진남로6길 32,44,62,38,144,48
3751,음식점,하효소머리국밥,제주특별자치도 서귀포시 효돈로 174,50,49,46,145,48
133,관광지,나틸다,제주특별자치도 제주시 아란5길 31-6,55,44,45,144,48
1546,숙박,바다파파,제주특별자치도 제주시 조천읍 신촌10길 7,45,52,48,145,48
1642,숙박,서귀포통나무집,제주특별자치도 서귀포시 칠십리로503번길 1,46,54,45,145,48
2131,숙박,해뜨는집 (도두),제주특별자치도 제주시 서해안로 234,43,63,39,145,48
1953,숙박,제주팡숑예래,제주특별자치도 서귀포시 예래해안로 357,59,45,39,143,48
1416,숙박,돌집조앤정,제주특별자치도 제주시 구좌읍 세화합전1길 7,43,45,55,143,48
2518,음식점,두리호집,제주특별자치도 제주시 한림읍 한림해안로 127,44,44,55,143,48
3669,음식점,탑부평,제주특별자치도 제주시 관덕로15길 26,41,44,59,144,48
3614,음식점,카페콧수염,제주특별자치도 제주시 구좌읍 해맞이해안로 402,45,47,53,145,48
1197,쇼핑,용연낚시,제주특별자치도 제주시 용담2동 465,42,48,53,143,48
3006,음식점,수다브런치카페,제주특별자치도 제주시 남광로2길 39-23,45,58,41,144,48
3113,음식점,알라스카인제주 협재점,제주특별자치도 제주시 한림읍 협재6길 1,50,41,53,144,48
2622,음식점,만세국수 삼성혈점,제주특별자치도 제주시 삼성로 29,48,52,42,142,47
2912,음식점,삼원정,제주특별자치도 서귀포시 색달중앙로 44,44,51,47,142,47
3218,음식점,오쿠다 이도점,제주특별자치도 제주시 구남동4길 45,50,46,45,141,47
1421,숙박,동복리671,제주특별자치도 제주시 구좌읍 구좌해안로 52-13,39,59,44,142,47
2697,음식점,무상찻집,제주특별자치도 제주시 서광로5길 10,52,49,39,140,47
2954,음식점,섭지코지화덕피자,제주특별자치도 서귀포시 성산읍 신양로 102,51,46,44,141,47
3134,음식점,야자수 식당,제주특별자치도 제주시 한림읍 한림로 300,44,44,52,140,47
1550,숙박,바닷가하얀집,제주특별자치도 서귀포시 태평로120번길 29-2,55,47,39,141,47
2758,음식점,바램목장&카페,제주특별자치도 서귀포시 안덕면 신화역사로 611,59,51,31,141,47
2584,음식점,리틀비엣,제주특별자치도 제주시 인다7길 16,45,46,50,141,47
3793,음식점,해왓,제주특별자치도 서귀포시 성산읍 신고로 30-1,47,50,44,141,47
1393,숙박,더레드관광호텔,제주특별자치도 제주시 동광로6길 10,60,45,37,142,47
246,관광지,마라도관광쉼터,제주특별자치도 서귀포시 대정읍 마라로 139,47,47,46,140,47
1841,숙박,위더스펜션,제주시 애월읍 애월로 7길 24-3,44,57,40,141,47
1415,숙박,돌담한길펜션,제주특별자치도 서귀포시 남원읍 한신로 55,53,46,41,140,47
1408,숙박,도로시게스트하우스,제주특별자치도 서귀포시 성산읍 시흥상동로68번길 26-1,51,48,43,142,47
3235,음식점,옹포별장가든,제주특별자치도 제주시 한림읍 한림상로 24,52,46,42,140,47
3823,음식점,호돌이식당,제주특별자치도 제주시 한림읍 비양도길 284,36,43,61,140,47
325,관광지,배령연대,제주특별자치도 제주시 한림읍 금능리 1649,54,49,39,142,47
2838,음식점,부자식당,제주특별자치도 제주시 서광로5길 9,53,53,34,140,47
2235,음식점,갯것이식당,제주특별자치도 제주시 가령로 9,50,47,43,140,47
2930,음식점,서귀포흑돈,제주특별자치도 서귀포시 칠십리로 278,41,62,37,140,47
2665,음식점,명태명가,제주특별자치도 제주시 연북로 514,61,43,38,142,47
3300,음식점,웬드구니,제주특별자치도 서귀포시 안덕면 사계신항로 1,53,57,31,141,47
3728,음식점,피즈,제주특별자치도 제주시 애월읍 애월로 29,56,36,48,140,47
2446,음식점,더꽃돈,제주특별자치도 제주시 한림읍 한림로 366,60,38,43,141,47
2802,음식점,보레드베이커스,제주특별자치도 서귀포시 보목로64번길 178,48,49,45,142,47
3054,음식점,시골길,제주특별자치도 제주시 연동13길 9,49,49,42,140,47
3745,음식점,하와이새우트럭,제주특별자치도 제주시 노형13길 16,68,34,40,142,47
3176,음식점,연우네,제주특별자치도 제주시 은수길 110,64,42,36,142,47
1924,숙박,제주썬호텔&카지노,제주특별자치도 제주시 삼무로 67,61,51,29,141,47
1372,숙박,다이아몬드 호텔,제주특별자치도 제주시 신대로12길 42,50,57,34,141,47
3230,음식점,올레산야초,제주특별자치도 제주시 애월읍 유수암서길 57,54,48,38,140,47
1607,숙박,블루오션,제주특별자치도 서귀포시 대정읍 가파로 53,48,59,35,142,47
3412,음식점,제주머슴네,제주특별자치도 제주시 한림읍 옹포2길 8,57,47,36,140,47
2142,숙박,해아래펜션,제주특별자치도 제주시 애월읍 번대동길 5,43,46,52,141,47
3740,음식점,하몽인제주,제주특별자치도 제주시 한림읍 한림로 242,46,48,48,142,47
3416,음식점,제주복돈,제주특별자치도 제주시 1100로 3164,53,50,39,142,47
1624,숙박,빌림,제주특별자치도 제주시 오래물길 23,52,56,32,140,47
1132,쇼핑,돌코롱,제주특별자치도 서귀포시 대정읍 마라로 41,42,55,43,140,47
642,관광지,예초리,제주특별자치도 제주시 추자도 예초리,40,49,52,141,47
2057,숙박,팜핑제주,제주특별자치도 서귀포시 중산간서로400번길 105,43,53,44,140,47
2874,음식점,빵하우스,제주특별자치도 서귀포시 문부로11번길 10,46,59,37,142,47
2195,음식점,1950하우스,제주특별자치도 제주시 애월읍 평화로 2369,50,53,38,141,47
1825,숙박,와락 게스트하우스,제주특별자치도 제주시 구좌읍 세평항로 45-4,63,47,31,141,47
2045,숙박,파도봐펜션,제주특별자치도 서귀포시 남원읍 남태해안로 141,43,54,44,141,47
2525,음식점,딤섬9898,제주특별자치도 제주시 노형8길 17 행복한빌딩 102호,38,55,46,139,46
2502,음식점,동도원,제주특별자치도 서귀포시 이어도로 189,39,52,47,138,46
3093,음식점,아리(あり),제주특별자치도 서귀포시 홍중로 99,55,43,41,139,46
1830,숙박,우도쉼팡게스트하우스,제주특별자치도 제주시 우도면 우도로 7,47,44,47,138,46
1496,숙박,마라도별장,제주특별자치도 서귀포시 대정읍 마라로101번길 43,52,47,40,139,46
3239,음식점,와팡,제주특별자치도 서귀포시 이어도로 36-30,49,49,40,138,46
1896,숙박,제주란펜션,제주특별자치도 제주시 애월읍 애월해안로 446,42,62,34,138,46
1912,숙박,제주비치펜션,제주특별자치도 제주시 애월읍 애월해안로 384-12,45,47,45,137,46
3464,음식점,좀녀마을뚝배기,제주특별자치도 제주시 은남길 25,51,52,36,139,46
3385,음식점,제대가는길,제주특별자치도 제주시 제주대학로 75-1,47,53,39,139,46
1382,숙박,달집게스트하우스,제주특별자치도 제주시 구좌읍 종달논길 32-3,56,37,44,137,46
3268,음식점,우리두리식당,제주특별자치도 제주시 구좌읍 김녕로 173,46,37,55,138,46
1341,숙박,남촌풀하우스,제주도 서귀포시 표선면 표선동서로 139,51,58,28,137,46
1759,숙박,알로하민박,제주특별자치도 제주시 한림읍 협재1길 24,45,50,42,137,46
1750,숙박,아쿠아뷰티크,제주특별자치도 제주시 구좌읍 해맞이해안로 526,41,54,43,138,46
2814,음식점,복댕이,제주특별자치도 서귀포시 성산읍 일출로 34,40,49,49,138,46
3770,음식점,한우네백년해장국,제주특별자치도 제주시 신산로 6,72,40,26,138,46
2044,숙박,파더하우스,제주특별자치도 제주시 애월읍 고하상로 88,38,53,46,137,46
3659,음식점,타이웍,제주특별자치도 제주시 신설로11길 2,45,49,44,138,46
2960,음식점,성미식당,제주특별자치도 제주시 삼도1동 571-7,53,47,39,139,46
1121,쇼핑,기영상회,제주특별자치도 제주시 한림읍 한림로 345,40,51,47,138,46
2488,음식점,돌미롱,제주특별자치도 제주시 아란7길 14,48,36,55,139,46
1622,숙박,빌라배알로,제주특별자치도 서귀포시 성산읍 환해장성로 941,52,47,40,139,46
3662,음식점,탐라 뚝배기,제주특별자치도 서귀포시 표선면 표선백사로 127,50,36,52,138,46
1503,숙박,마주보기펜션,제주특별자치도 서귀포시 성산읍 해맞이해안로 2609,37,64,38,139,46
2594,음식점,마라도해녀촌짜장,제주특별자치도 서귀포시 대정읍 마라로 41,37,50,52,139,46
1652,숙박,성산우리집 펜션,제주특별자치도 서귀포시 성산읍 한도로255번길 9,43,48,47,138,46
1431,숙박,드림캐슬,제주특별자치도 서귀포시 남원읍 남태해안로 364,54,50,34,138,46
2113,숙박,하와이펜션,제주특별자치도 제주시 도두봉2길 75,44,50,43,137,46
3344,음식점,인어공주,제주특별자치도 제주시 우도면 우도해안길 780-2,42,42,54,138,46
3843,음식점,회양과 국수군,제주특별자치도 제주시 우도면 우도해안길 270,46,51,42,139,46
1671,숙박,송림원,제주특별자치도 제주시 애월읍 천덕로 313-3,46,48,43,137,46
3478,음식점,중문수두리보말칼국수,제주특별자치도 서귀포시 천제연로 192,60,44,34,138,46
1292,숙박,구름비낭,제주특별자치도 제주시 한경면 판포중2길 15,43,50,44,137,46
2491,음식점,돌카롱 사려니숲길점,제주특별자치도 제주시 조천읍 비자림로 422-2,53,42,43,138,46
3506,음식점,쪼끌락,제주특별자치도 제주시 구좌읍 김녕로21길 21,44,47,47,138,46
3210,음식점,오메오메,제주특별자치도 제주시 애월읍 광령남3길 49,46,42,49,137,46
2418,음식점,달아래팥,제주특별자치도 제주시 한경면 낙수로 148,41,54,43,138,46
2121,숙박,한라하이츠펜션,제주특별자치도 서귀포시 고근산로202번길 94,45,49,43,137,46
3487,음식점,중화요리 사해방,제주특별자치도 서귀포시 천제연로 263,40,52,47,139,46
2396,음식점,다다익고 정육식당,제주특별자치도 서귀포시 색달로 25,56,48,34,138,46
2380,음식점,녹원전통찻집,제주특별자치도 제주시 중앙로 122-2,54,41,43,138,46
2423,음식점,달페이지,제주특별자치도 서귀포시 색달로64번길 51,38,54,45,137,46
2207,음식점,BBQ치킨 추자점,제주특별자치도 제주시 추자면 추자로 14-4,48,42,47,137,46
432,관광지,샘이오름,제주특별자치도 제주시 조천읍 516로,56,44,39,139,46
3533,음식점,청년다방 이도점,제주특별자치도 제주시 남광로2길 41-1,36,53,49,138,46
3317,음식점,윤옥,제주특별자치도 제주시 구남동2길 19-4,44,49,46,139,46
1905,숙박,제주목화휴양펜션,제주특별자치도 서귀포시 남원읍 태위로 483,44,62,31,137,46
2643,음식점,머문카페,제주특별자치도 제주시 구좌읍 해맞이해안로 460,45,51,41,137,46
3644,음식점,코코티에,제주특별자치도 서귀포시 표선면 표선당포로 21-3,40,47,51,138,46
2833,음식점,뵤뵤,제주특별자치도 제주시 한림읍 명재로 155,43,59,35,137,46
2985,음식점,소길역,제주특별자치도 제주시 애월읍 소길2길 53,48,58,31,137,46
1556,숙박,바사팬스파,제주특별자치도 제주시 한경면 한경해안로 448-6,51,45,42,138,46
425,관광지,상추자항,제주특별자치도 제주시 추자면 추자로 39,56,48,33,137,46
2330,음식점,김이박,제주특별자치도 제주시 인다9길 20,43,48,48,139,46
3312,음식점,유메야마,제주특별자치도 제주시 노연로 12,52,48,34,134,45
3452,음식점,제주통큰장어,제주특별자치도 제주시 청귤로3길 50,50,41,45,136,45
3706,음식점,평대랑 그네랑,제주특별자치도 제주시 구좌읍 대수길 22,45,52,39,136,45
2644,음식점,먹쿠슬낭여행자카페,제주특별자치도 제주시 오라로 24,39,49,46,134,45
1614,숙박,비아 제주,제주특별자치도 제주시 삼무로9길 11,55,44,35,134,45
3667,음식점,탐라흑돼지,제주특별자치도 서귀포시 성산읍 성산중앙로 60-1,50,44,41,135,45
1630,숙박,사계절민박,제주특별자치도 제주시 추자면 신양2길 12,56,37,41,134,45
1629,숙박,사계여행민박,제주특별자치도 서귀포시 안덕면 산방로 262,38,59,39,136,45
3446,음식점,제주진미마돈가,제주특별자치도 서귀포시 안덕면 대평감산로 17,49,50,37,136,45
3572,음식점,카페 도두,제주특별자치도 제주시 서해안로 342,47,48,41,136,45
1634,숙박,산방산에펜션,제주특별자치도 서귀포시 안덕면 사계북로41번길 151,50,56,29,135,45
1641,숙박,서귀포귤림성,제주특별자치도 서귀포시 일주동로 8941,48,43,44,135,45
2256,음식점,고망딱새,제주특별자치도 제주시 서해안로 96,39,57,40,136,45
2056,숙박,팜빌리지,제주특별자치도 서귀포시 속골로 29-10,48,47,39,134,45
3474,음식점,중문대들보,제주특별자치도 서귀포시 천제연로 135,60,43,33,136,45
2092,숙박,피우다 게스트하우스,제주특별자치도 제주시 한경면 저지12길 60-4,40,49,46,135,45
2429,음식점,대기정,제주특별자치도 서귀포시 이어도로 41,54,50,31,135,45
3198,음식점,오데뜨,제주특별자치도 제주시 애월읍 애원로 289,43,48,43,134,45
2387,음식점,느지리식식당,제주특별자치도 제주시 한림읍 상한로 4,47,42,46,135,45
2032,숙박,태흥리조트,제주특별자치도 서귀포시 남원읍 태위로 988-6,42,47,47,136,45
1564,숙박,배목수집,제주특별자치도 제주시 구좌읍 세송로 43,40,58,38,136,45
3255,음식점,우도면파전리,제주특별자치도 제주시 우도면 우도해안길 388,44,49,43,136,45
2040,숙박,토토하우스,제주특별자치도 제주시 애월읍 광령자종길 14,37,56,41,134,45
2614,음식점,만민식당,제주특별자치도 제주시 한림읍 중산간서로 4618-1,43,51,41,135,45
1722,숙박,씨앤관광호텔,제주특별자치도 제주시 일주서로 7490,36,59,41,136,45
3771,음식점,한치앞도모를바다,제주특별자치도 제주시 한림읍 협재6길 9,44,45,46,135,45
3048,음식점,스테이위드커피,제주특별자치도 서귀포시 안덕면 형제해안로 32,51,47,37,135,45
2143,숙박,해안길펜션,제주특별자치도 제주시 우도면 우도해안길 690,44,57,33,134,45
1270,숙박,강정서부민박,제주도 서귀포시 이어도로 602,41,52,42,135,45
1932,숙박,제주영숙,제주특별자치도 서귀포시 남원읍 태수로26번길 17,42,40,52,134,45
3137,음식점,양촌리마을,제주특별자치도 제주시 진군길 31-5,39,50,45,134,45
2877,음식점,뿔소라몽땅정식,제주특별자치도 서귀포시 이어도로 866-27,48,42,44,134,45
1194,쇼핑,연필가게,"제주특별자치도 서귀포시 남원읍 태위로 929 (태흥리, 뽀글이미용실)",54,43,39,136,45
2947,음식점,선흘방주할매식당,제주특별자치도 제주시 조천읍 선교로 212,41,60,35,136,45
1179,쇼핑,시티오브드림즈,제주특별자치도 제주시 관덕로11길 17,37,61,37,135,45
1385,숙박,담앤루펜션리조트,제주특별자치도 서귀포시 이어도로343번길 63,42,52,41,135,45
1254,숙박,UncleBORO게스트하우스,제주특별자치도 제주시 한경면 저지12길 60-6,33,59,43,135,45
2858,음식점,비양도 올레카페,제주특별자치도 제주시 한림읍 비양도길 24,51,46,38,135,45
3840,음식점,황우정,제주특별자치도 제주시 도령로 46,75,41,18,134,45
2916,음식점,새벽숯불가든,제주특별자치도 서귀포시 성산읍 일주동로 4036,57,41,38,136,45
2866,음식점,비포크비스트로,제주특별자치도 서귀포시 태평로 417-1,50,39,47,136,45
3583,음식점,카페더몹시,제주특별자치도 제주시 월대1길 10,40,50,45,135,45
2890,음식점,산방산에 옛촌,제주특별자치도 서귀포시 안덕면 사계로 189,37,55,44,136,45
3339,음식점,인그리드,제주특별자치도 제주시 서해안로 64,39,37,58,134,45
3546,음식점,촌촌해녀촌,제주특별자치도 제주시 구좌읍 동복로 35,41,49,44,134,45
1606,숙박,블루마운틴호텔,제주특별자치도 서귀포시 성산읍 일출로 297,45,55,35,135,45
1589,숙박,봉아저씨네민박,제주특별자치도 제주시 한림읍 명상로 8-4,36,48,50,134,45
1476,숙박,로즈비치,제주특별자치도 제주시 조천읍 조함해안로 162,39,66,30,135,45
1307,숙박,금서방네이층집,제주특별자치도 서귀포시 안덕면 덕수회관로 61번길 1,41,46,47,134,45
1142,쇼핑,마켓오름,제주특별자치도 서귀포시 이어도로 1061,44,50,40,134,45
3177,음식점,연이네,제주특별자치도 제주시 우도면 우도해안길 662-1,36,49,51,136,45
2747,음식점,바다잔치,제주특별자치도 제주시 탑동로 79,43,53,37,133,44
1757,숙박,안트레 펜션,제주특별자치도 제주시 한림읍 한림중앙로 154-7,48,42,43,133,44
2169,숙박,호텔난타,제주특별자치도 제주시 선돌목동길 56-26,41,48,44,133,44
2246,음식점,경성통닭,제주특별자치도 서귀포시 중앙로42번길 17,59,48,25,132,44
3266,음식점,우드스탁,제주특별자치도 제주시 구좌읍 월정7길 52,41,49,43,133,44
1635,숙박,산방산호텔,제주특별자치도 서귀포시 대정읍 일주서로 2093,59,54,20,133,44
3202,음식점,오라디오라,제주특별자치도 서귀포시 안덕면 사계로114번길 54-102,44,39,49,132,44
1344,숙박,내사랑추자야펜션민박,제주특별자치도 제주시 추자면 추자로 104-2,41,36,55,132,44
1625,숙박,빠담빠담게스트하우스,제주특별자치도 서귀포시 표선면 돈오름로 198-4,39,55,39,133,44
1508,숙박,메이풀하우스,제주특별자치도 제주시 조천읍 곱은달서길 165,36,49,46,131,44
947,관광지,"천아오름(?낭오름,天娥岳)",제주특별자치도 제주시 애월읍 산록서로 678-207,133,0,0,133,44
2012,숙박,코델리아리조트,제주특별자치도 서귀포시 성산읍 일주동로4120번길 23-20,39,53,39,131,44
3788,음식점,해마루,제주특별자치도 서귀포시 성산읍 일출로 84,47,40,44,131,44
3797,음식점,해적카페,제주특별자치도 제주시 우도면 우도해안길 794-4,38,43,51,132,44
1575,숙박,베니키아호텔제주,제주특별자치도 제주시 애월읍 애월해안로 554-10,48,40,45,133,44
3183,음식점,영춘식당,제주특별자치도 제주시 도남로7길 37-1,49,46,37,132,44
1623,숙박,빌라비하우스,제주특별자치도 서귀포시 색달로64번길 51,48,42,43,133,44
3577,음식점,카페2085,제주특별자치도 제주시 조천읍 선교로 185,49,45,39,133,44
2704,음식점,문어빵굽는문빵9,제주특별자치도 제주시 우도면 우도해안길 388,56,42,34,132,44
3736,음식점,하례정원,제주특별자치도 서귀포시 남원읍 하례망장포로 39,47,38,48,133,44
2493,음식점,돌코롬봉봉,제주특별자치도 서귀포시 표선면 민속해안로 35,45,46,40,131,44
2695,음식점,무거버거,제주특별자치도 제주시 조천읍 조함해안로 356,40,40,52,132,44
2379,음식점,녹나무,제주특별자치도 제주시 노연로 12,43,48,41,132,44
3130,음식점,애월은혜전복,제주특별자치도 제주시 애월읍 애월로1길 24-3,48,46,37,131,44
1338,숙박,나인스파빌,제주특별자치도 제주시 애월읍 하광로 518,41,54,36,131,44
1432,숙박,드헤브펜션,제주특별자치도 제주시 구좌읍 문주란로1길 74-24,41,54,37,132,44
2668,음식점,모노클제주,제주특별자치도 서귀포시 남원읍 태위로360번길 30-8,38,43,51,132,44
2688,음식점,몬스테라 자구리,제주특별자치도 서귀포시 소암로12번길 7,49,43,40,132,44
3160,음식점,엉클통김밥(본점),제주특별자치도 제주시 1100로 3283,42,51,40,133,44
2805,음식점,보말과풍경,제주특별자치도 서귀포시 대정읍 하모중앙로 17,44,49,39,132,44
3097,음식점,아웃도어키친,제주특별자치도 서귀포시 동홍로 370,45,47,39,131,44
3436,음식점,제주올레횟집,제주특별자치도 서귀포시 칠십리로 45,51,42,38,131,44
513,관광지,송계순집터,제주특별자치도 서귀포시 대정읍 안성리 1681-1,42,48,41,131,44
2352,음식점,나원회포차,제주특별자치도 서귀포시 동문동로 2 (서귀동),62,32,37,131,44
1951,숙박,제주파크랜드,제주특별자치도 제주시 애월읍 상귀서길 82-20,43,50,40,133,44
2966,음식점,성산진미식당,제주특별자치도 서귀포시 성산읍 일출로 290,47,46,40,133,44
2882,음식점,사수만수횟집,제주특별자치도 제주시 서해안로 348-1,39,56,37,132,44
2104,숙박,하도하도1929,제주시 구좌읍 하도리 하도서문길 2,41,51,39,131,44
2109,숙박,하바다 통나무집,제주특별자치도 서귀포시 안덕면 대평감산로 86,42,56,33,131,44
2414,음식점,달리북카페,제주시 한림읍 월계로 18 1층,45,39,47,131,44
2133,숙박,해마지펜션,제주특별자치도 서귀포시 성산읍 일주동로 5431,53,37,42,132,44
1913,숙박,제주빌레성 통나무휴양펜션,제주특별자치도 서귀포시 성산읍 온평포구로 42,39,51,41,131,44
1806,숙박,오비두스,제주특별자치도 제주시 애월읍 신엄안3길 138,41,48,44,133,44
1747,숙박,아침의 새소리,제주특별자치도 서귀포시 남원읍 태수로358번길 3-1,38,55,39,132,44
2617,음식점,만부정,제주특별자치도 제주시 사장길 38,43,44,44,131,44
2676,음식점,모메든식당,제주특별자치도 서귀포시 일주서로 508,46,40,44,130,43
2035,숙박,테디밸리호텔,제주특별자치도 서귀포시 안덕면 한창로 365,48,46,35,129,43
2353,음식점,나주닭집,제주특별자치도 제주시 동광로1길 32,46,48,36,130,43
1628,숙박,쁘띠제주빅터펜션,제주특별자치도 제주시 서해안로 340,32,59,37,128,43
1498,숙박,마레카펜션,제주특별자치도 제주시 한림읍 금능1길 26,43,49,36,128,43
2992,음식점,소울키친,제주특별자치도 서귀포시 천제연로 131-7,40,38,52,130,43
1320,숙박,꿈꾸는 노마드,제주특별자치도 서귀포시 선반로 54,40,46,42,128,43
3731,음식점,하나로국밥,제주특별자치도 서귀포시 천제연로 222-2,49,46,34,129,43
2706,음식점,문화통닭,제주특별자치도 서귀포시 성산읍 고성오조로 81,40,44,45,129,43
1479,숙박,롯데시티호텔제주,제주특별자치도 제주시 도령로 83,40,47,42,129,43
3325,음식점,이노우에스시,제주특별자치도 제주시 과원로 78-1,35,61,32,128,43
1998,숙박,추자바다25시,제주특별자치도 제주시 추자면 묵리2길 48,44,36,49,129,43
3406,음식점,제주돌담촌,제주특별자치도 제주시 도남로 134,49,45,35,129,43
3241,음식점,외도339,제주특별자치도 제주시 일주서로 7345,42,48,40,130,43
1440,숙박,또오크라,제주특별자치도 제주시 애월읍 수산북길 31,45,48,35,128,43
3001,음식점,쇠소깍모꼬지,제주특별자치도 서귀포시 일주동로 8104,38,56,35,129,43
1961,숙박,제주하이킹 INN(구덕게스트하우스),제주특별자치도 서귀포시 솔동산로22번길 20,34,50,44,128,43
287,관광지,묵리해안쉼터,제주특별자치도 제주시 추자면 추자로 376-6,50,41,39,130,43
3587,음식점,카페루나,제주특별자치도 서귀포시 안덕면 화순서동로 57-3,33,48,47,128,43
2465,음식점,도다모,제주특별자치도 제주시 신설로11길 5,39,49,42,130,43
1451,숙박,라메종베니in제주,제주특별자치도 서귀포시 성산읍 신양로122번길 4-6,37,56,35,128,43
2812,음식점,보틀앤볼,제주특별자치도 서귀포시 일주동로 8712-2,43,42,45,130,43
3228,음식점,올랭이와물꾸럭,제주특별자치도 서귀포시 대정읍 신영로 93-5,44,44,40,128,43
1772,숙박,에띠에리조트,제주특별자치도 서귀포시 이어도로 738,40,50,39,129,43
2280,음식점,광평도새기촌 본점,제주특별자치도 제주시 애월읍 구엄동3길 64,42,50,36,128,43
3564,음식점,칠돈가 중문점,제주특별자치도 서귀포시 중문관광로 8,58,45,27,130,43
2382,음식점,누룽지식당,제주특별자치도 제주시 고산동산6길 15-1,50,35,43,128,43
1976,숙박,중문통나무휴양펜션,제주특별자치도 서귀포시 중산간서로594번길 7-8,45,48,36,129,43
3787,음식점,해뜰,제주특별자치도 서귀포시 성산읍 일출로 270-8,39,40,50,129,43
1796,숙박,연지민박,제주특별자치도 제주시 우도면 상우목길 26,44,41,45,130,43
1158,쇼핑,북타임,제주특별자치도 서귀포시 중앙로 109 2층,43,39,47,129,43
3333,음식점,이어도전복해물전문점,제주특별자치도 서귀포시 태평로 485 (동홍동),41,46,42,129,43
3070,음식점,신옛촌,제주특별자치도 서귀포시 안덕면 사계로 187-6,53,45,30,128,43
2978,음식점,세러데이아일랜드,제주특별자치도 제주시 구좌읍 평대7길 51,50,46,32,128,43
1343,숙박,내도바당펜션,제주특별자치도 제주시 내도중길 9-7,49,44,35,128,43
1337,숙박,나비스호텔,제주특별자치도 제주시 애월읍 애월해안로 885,47,43,39,129,43
2994,음식점,솔동산고기국수,제주특별자치도 서귀포시 부두로 23,43,41,44,128,43
3123,음식점,애월 고깃간,제주특별자치도 제주시 애월읍 애월해안로 32,52,46,30,128,43
2586,음식점,마농,제주시 우평로 45,39,53,37,129,43
2772,음식점,방긋스낵,제주특별자치도 제주시 구좌읍 행원로1길 32-5,37,46,45,128,43
1572,숙박,베누스무인텔,제주특별자치도 제주시 애월읍 유수암평화5길 92,34,56,39,129,43
2503,음식점,동동차이나,제주특별자치도 서귀포시 남원읍 태위로689번길 7,38,48,42,128,43
3816,음식점,협재온다정,제주특별자치도 제주시 한림읍 한림로 381-4,43,44,43,130,43
667,관광지,요가느림원,제주특별자치도 제주시 원노형2길 33,49,45,35,129,43
1535,숙박,민준채,제주특별자치도 제주시 한림읍 월령3길 27-5,36,49,44,129,43
2531,음식점,뚱보아저씨,제주특별자치도 제주시 한경면 중산간서로 3651,56,35,38,129,43
1303,숙박,그림같은풍경,제주도 서귀포시 대정읍 노을해안로 600,42,45,41,128,43
1542,숙박,바다와자전거,제주특별자치도 제주시 애월읍 고내로9길 42,46,55,29,130,43
2757,음식점,바람카페,제주특별자치도 제주시 516로 3041-15,34,52,43,129,43
970,관광지,추자도 숭어체험장,제주특별자치도 제주시 추자면 석두리길 4,43,49,37,129,43
972,관광지,추자등대,제주특별자치도 제주시 추자면 영흥리 77-3,35,48,45,128,43
2829,음식점,봉주르마담,제주특별자치도 서귀포시 대청로 33,62,38,29,129,43
1310,숙박,길섶나그네펜션,제주도 제주시 조천읍 미래로 241,46,45,39,130,43
3109,음식점,안다미로,제주특별자치도 제주시 조천읍 비자림로 648,39,48,42,129,43
2972,음식점,성아시,제주특별자치도 제주시 한림읍 금능길 68,37,38,54,129,43
3681,음식점,토계정,제주특별자치도 제주시 조천읍 교래3길 1,44,46,38,128,43
2436,음식점,대운정,제주특별자치도 제주시 도두항서길 41,42,54,34,130,43
1397,숙박,더비비스제주,제주특별자치도 서귀포시 이어도로 760,52,37,39,128,43
1300,숙박,그린사이드펜션,제주특별자치도 서귀포시 천제연로 51,47,52,29,128,43
2779,음식점,백사장횟집(백사장회센터),제주특별자치도 서귀포시 표선면 표선당포로 19-3,46,44,36,126,42
2770,음식점,반딧불한담,제주특별자치도 제주시 애월읍 애월로1길 24-11 (애월리),40,43,42,125,42
3780,음식점,해금강횟집,제주특별자치도 제주시 서부두길 28 (건입동),41,32,54,127,42
1519,숙박,몽마르뜨펜션,제주도 제주시 애월읍 애월해안로 384-23,56,42,29,127,42
3213,음식점,오솔길,제주특별자치도 제주시 임항로 264,35,40,52,127,42
424,관광지,상추자포구,제주특별자치도 제주시 추자면 대서리,55,40,30,125,42
3221,음식점,옥만이네,제주특별자치도 제주시 한림읍 한림해안로 160,44,37,44,125,42
2785,음식점,번개피자,제주특별자치도 서귀포시 안덕면 녹차분재로 218 항공우주박물관 3층,35,49,42,126,42
3808,음식점,헤이브라더,제주특별자치도 서귀포시 안덕면 형제해안로 72,51,35,41,127,42
3758,음식점,한라축산정육식당,제주특별자치도 제주시 한림읍 한림상로 84 A?,67,41,19,127,42
2654,음식점,면뽑는선생 만두빚는아내,제주특별자치도 제주시 한림읍 옹포2길 10,49,29,47,125,42
1866,숙박,자연인,제주특별자치도 제주시 아란서길 110,39,56,31,126,42
2411,음식점,달래식당,제주특별자치도 서귀포시 성산읍 금백조로 34-19,54,34,39,127,42
2415,음식점,달마야해물탕,제주특별자치도 제주시 조천읍 신북로 535-1,43,46,36,125,42
2139,숙박,해비치 바람의집 펜션&카페,제주특별자치도 서귀포시 표선면 민속해안로 381,49,34,44,127,42
1410,숙박,도일모텔,제주특별자치도 제주시 신광로 102,50,38,38,126,42
2108,숙박,하바나블루스,제주특별자치도 제주시 한경면 한경해안로 474-26,37,48,40,125,42
2881,음식점,사방팔방,제주특별자치도 제주시 우정로10길 12,35,47,43,125,42
3483,음식점,중문정,제주특별자치도 서귀포시 상예로 226,38,47,41,126,42
2340,음식점,꽁순이네,제주특별자치도 제주시 애월읍 중산간서로 5642,41,41,43,125,42
3643,음식점,코코분식,제주특별자치도 제주시 신성로 104,45,37,44,126,42
3619,음식점,카페한라산,제주특별자치도 제주시 구좌읍 면수1길 48,52,37,36,125,42
3341,음식점,인디안썸머애월,제주특별자치도 제주시 애월읍 애월로4길 9,42,50,34,126,42
2948,음식점,섬마을청년회관,제주특별자치도 제주시 용화로 58,47,36,42,125,42
1409,숙박,도시락게스트하우스,제주특별자치도 서귀포시 성산읍 성산중앙로 48,39,50,36,125,42
3752,음식점,한담팥빵,제주특별자치도 제주시 도령로 70 1층,48,43,34,125,42
3227,음식점,올래회어촌,제주특별자치도 제주시 테우해안로 166 (이호일동),42,48,35,125,42
2230,음식점,감초식당,제주특별자치도 제주시 동광로1길 32,46,48,33,127,42
2033,숙박,태흥여관,제주특별자치도 제주시 추자면 추자로 34,33,43,51,127,42
2671,음식점,모디카,제주특별자치도 제주시 한림읍 한림상로 134-5,48,45,33,126,42
1330,숙박,나무이야기게스트하우스,제주특별자치도 서귀포시 남원읍 태신삼석로 6,42,53,31,126,42
3657,음식점,킴스커틀렛,제주특별자치도 제주시 구남로4길 11,42,47,37,126,42
3404,음식점,제주다음,제주특별자치도 서귀포시 보목포로 27,45,48,32,125,42
2484,음식점,돈카츠서황,제주특별자치도 제주시 애월읍 장소로 205-2,47,41,38,126,42
1390,숙박,더갤러리펜션,제주특별자치도 제주시 조천읍 남조로 1717-24,38,49,40,127,42
1954,숙박,제주펄관광호텔,제주특별자치도 제주시 신대로20길 49,55,45,27,127,42
1124,쇼핑,다나한한복 앤 러블리베베,제주특별자치도 제주시 연삼로 355,43,39,43,125,42
2860,음식점,비어라운드(Be around),제주특별자치도 제주시 구좌읍 하도9길 72,43,53,31,127,42
3008,음식점,수망일기,제주특별자치도 서귀포시 남원읍 남조로 593-2,38,42,45,125,42
2546,음식점,랜딩 라운지,제주 서귀포시 안덕면 신화역사로304번길 38 랜딩관 제주신화월드 호텔앤리조트 G층,41,49,35,125,42
1955,숙박,제주펜션오다,제주특별자치도 제주시 서해안로 452,44,40,42,126,42
2856,음식점,비바리짬뽕,제주특별자치도 제주시 애월읍 하귀9길 11,39,44,43,126,42
522,관광지,송죽사터,제주특별자치도 서귀포시 대정읍 안성리,47,43,37,127,42
3393,음식점,제주 강남해물탕,제주특별자치도 서귀포시 대정읍 형제해안로 316,55,39,33,127,42
3277,음식점,우정회센타,제주특별자치도 서귀포시 중앙로54번길 32 (서귀동),42,42,43,127,42
2208,음식점,Jeju in aA카페,제주특별자치도 제주시 구좌읍 계룡길 26-20,40,49,36,125,42
1255,숙박,ZeZuZip,제주 특별자치도 서귀포시 성산읍 삼달로 235-17,32,51,44,127,42
2666,음식점,명품전통육개장 본점,제주특별자치도 제주시 원노형로 37,47,57,23,127,42
1494,숙박,마당돌펜션,제주특별자치도 서귀포시 대정읍 노을해안로 410,34,59,34,127,42
1867,숙박,장원민박,제주특별자치도 서귀포시 천제연로 49,35,59,33,127,42
1777,숙박,에이티눈호텔,제주특별자치도 제주시 은남1길 8,52,45,30,127,42
1391,숙박,더그랜드섬오름,제주특별자치도 서귀포시 막숙포로 118,42,49,36,127,42
3690,음식점,티나케이크,제주특별자치도 서귀포시 서문로 61,39,47,36,122,41
1460,숙박,라헨느리조트,제주특별자치도 제주시 명림로 384,36,52,36,124,41
3289,음식점,원조마라도짜장면,제주특별자치도 서귀포시 대정읍 마라로101번길 46,40,48,34,122,41
3371,음식점,저스트쉬림프,제주특별자치도 제주시 애월읍 하귀10길 49-1,36,33,53,122,41
2836,음식점,부엌인세화,제주특별자치도 제주시 구좌읍 해맞이해안로 1460,46,35,41,122,41
2835,음식점,부르네비어가든,제주특별자치도 제주시 서해안로 376,37,46,41,124,41
2569,음식점,루스트플레이스 아라점,제주특별자치도 제주시 아란7길 3-3,33,51,39,123,41
1857,숙박,이야기별방,제주특별자치도 제주시 구좌읍 해맞이해안로 2040,29,50,43,122,41
1404,숙박,더하도스파빌라,제주특별자치도 제주시 구좌읍 하도13길 66,44,44,35,123,41
1853,숙박,이레민박,제주특별자치도 제주시 추자면 신양1길 22-9,40,41,41,122,41
1377,숙박,단추스테이 단추숲,제주특별자치도 제주시 한경면  고조로 311-8,39,56,27,122,41
1741,숙박,아이미 제주비치 호텔,제주특별자치도 제주시 조천읍 조함해안로 474,39,45,40,124,41
1949,숙박,제주파도소리,제주특별자치도 제주시 구좌읍 해맞이해안로 1950,32,51,40,123,41
1361,숙박,늘바다통나무펜션,제주특별자치도 서귀포시 안덕면 대평로 38,35,34,54,123,41
2615,음식점,만배성,제주특별자치도 제주시 아연로 484-9,41,43,40,124,41
2520,음식점,둥지식당,제주특별자치도 서귀포시 성산읍 성산등용로 96-3,41,34,49,124,41
1958,숙박,제주프렌즈펜션,제주특별자치도 제주시 한경면 판포2길 35,34,52,36,122,41
3124,음식점,애월 우니담,제주특별자치도 제주시 애월읍 고내로13길 107,61,36,27,124,41
1456,숙박,라이온힐펜션,제주특별자치도 서귀포시 안덕면 평화로 507,38,52,34,124,41
2773,음식점,방듸,제주특별자치도 서귀포시 성산읍 섭지코지로 48,38,48,36,122,41
2682,음식점,모앙,제주시 인다5길 12-4,47,40,37,124,41
3302,음식점,위더스트래블,제주특별자치도 제주시 인다9길 29,36,47,40,123,41
1116,쇼핑,곱은과일,제주특별자치도 서귀포시 동문로 10,29,39,55,123,41
3116,음식점,앙뚜아네트 삼다수마을점,제주특별자치도 제주시 조천읍 비자림로 606,42,51,30,123,41
2708,음식점,물꼬해녀의집,제주특별자치도 제주시 우도면 우도해안길 496,38,49,36,123,41
3379,음식점,정순화손두부,제주특별자치도 제주시 조천읍 일주동로 1415,48,39,35,122,41
1977,숙박,중문햇빛펜션,제주특별자치도 서귀포시 안덕면 쇠물도로 14,43,36,44,123,41
1885,숙박,제주금산펜션,제주특별자치도 제주시 애월읍 납읍로2길 40,40,58,24,122,41
2976,음식점,섶섬지기,제주특별자치도 서귀포시 보목로64번길 79,44,30,49,123,41
2880,음식점,사려니숲길화덕피자,제주특별자치도 제주시 조천읍 남조로 2133,46,48,29,123,41
2453,음식점,덕승식당(구관),제주특별자치도 서귀포시 대정읍 하모항구로 66,28,53,42,123,41
2083,숙박,풍경호텔(풍경관광호텔),제주특별자치도 서귀포시 남성중로 147,46,45,33,124,41
2485,음식점,돈파스타정원,제주특별자치도 제주시 애월읍 애월해안로 364,46,46,32,124,41
2302,음식점,그랜드 키친,제주특별자치도 제주시 노연로 12,43,43,37,123,41
2932,음식점,서문뒷고기,제주특별자치도 제주시 중앙로14길 40-2,38,40,44,122,41
3515,음식점,착한집,제주특별자치도 제주시 우평로 29,40,42,41,123,41
2884,음식점,사이카레,제주특별자치도 제주시 애월읍 애월해안로 752 2층,38,43,42,123,41
2189,숙박,흰고래게스트하우스,제주특별자치도 서귀포시 이어도로1066번길 26,35,48,41,124,41
1195,쇼핑,옥수카페,제주특별자치도 제주시 애월읍 소길1길 19,43,42,38,123,41
2041,숙박,통나무파크,제주특별자치도 제주시 애월읍 도치돌길 293,31,50,43,124,41
1888,숙박,제주도 레인보우,제주특별자치도 제주시 구좌읍 종달로 68-2,36,46,42,124,41
1137,쇼핑,딜다책방,제주특별자치도 제주시 삼성로1길 1,36,48,39,123,41
1483,숙박,루시드엠,제주특별자치도 서귀포시 안덕면 사계북로 120,51,42,31,124,41
2943,음식점,석다원,제주특별자치도 제주시 구좌읍 해맞이해안로 1752,41,49,33,123,41
1383,숙박,달콤한소금만들기,제주특별자치도 서귀포시 안덕면 사계로 100,36,45,42,123,41
1632,숙박,사랑터울,제주특별자치도 제주시 어영길 25,36,64,23,123,41
3395,음식점,제주 핫팟,제주특별자치도 제주시 노연로 12,46,48,30,124,41
3171,음식점,여행가게,"제주특별자치도 서귀포시 남원읍 태위로 929 (태흥리, 뽀글이미용실) 1층",40,41,41,122,41
2534,음식점,뜰향기,제주특별자치도 제주시 조천읍 남조로 2326,47,35,40,122,41
1467,숙박,레몬트리게스트하우스,제주특별자치도 서귀포시 대정읍 하모항구로 70,40,48,35,123,41
3387,음식점,제레미,제주특별자치도 제주시 애월읍 애월로 106-1,39,38,45,122,41
2185,숙박,훼밀리민박,제주특별자치도 서귀포시 안덕면 형제해안로 24,45,36,41,122,41
3494,음식점,지오아라,제주특별자치도 서귀포시 안덕면 사계로114번길 54-86,49,42,32,123,41
3024,음식점,순이네해장국,제주특별자치도 제주시 오복4길 8,40,48,33,121,40
1939,숙박,제주의시간은느리다,제주특별자치도 제주시 구좌읍 상도로 30-4,49,43,29,121,40
3401,음식점,제주기사정식뷔페,제주특별자치도 제주시 공설로 23,55,37,28,120,40
1916,숙박,제주샘모루펜션,제주특별자치도 서귀포시 염돈로28번길 11,44,35,40,119,40
1369,숙박,다솜펜션,제주특별자치도 서귀포시 이어도로 139,51,41,29,121,40
1315,숙박,까사데비발디호텔,제주특별자치도 서귀포시 안덕면 향교로 214,35,54,30,119,40
3654,음식점,키친그듸,제주특별자치도 제주시 애월읍 하귀동남1길 25-1 1층,39,46,35,120,40
2086,숙박,프레리아,제주특별자치도 제주시 애월읍 유수암평화5길 34-29,34,40,45,119,40
2451,음식점,더화원,제주특별자치도 제주시 도리로 132,46,49,26,121,40
2878,음식점,쁠랑뜨,제주특별자치도 제주시 1100로 2977-15,42,41,38,121,40
3712,음식점,포차,제주특별자치도 제주시 노연로 12,40,41,38,119,40
3687,음식점,토향(음식점),제주특별자치도 서귀포시 남원읍 태위로679번길 7-1,34,43,44,121,40
2567,음식점,루스트플레이스 서귀포점,제주특별자치도 서귀포시 신서로48번길 22,32,49,40,121,40
1946,숙박,제주코기네,제주특별자치도 제주시 조천읍 조함해안로 76-34,43,40,36,119,40
3473,음식점,중국집마씸,제주특별자치도 제주시 한경면 두신로 78,50,34,37,121,40
2091,숙박,피디스테이션,제주특별자치도 제주시 구좌읍 평대10길 45-46,41,33,47,121,40
1945,숙박,제주캠핑올레,제주도 서귀포시 표선면 토산망동로 15,40,43,38,121,40
2486,음식점,돈풍년,제주특별자치도 제주시 승천로 52,44,40,36,120,40
1405,숙박,더하우스펜션,제주특별자치도 제주시 구좌읍 해맞이해안로 2060,49,44,26,119,40
2581,음식점,리치망고 신화월드점,제주특별자치도 서귀포시 안덕면 신화역사로304번길 38,35,45,40,120,40
3099,음식점,아이스크림연구소(우도점),제주시 우도면 우도봉길 47,36,44,40,120,40
3639,음식점,코끼리통닭,제주특별자치도 제주시 동문로 4,47,42,31,120,40
3368,음식점,장승포식당,제주특별자치도 서귀포시 성산읍 동류암로 32,49,40,31,120,40
2105,숙박,하랑 게스트하우스,제주특별자치도 서귀포시 대정읍 일과로13번길 1,41,40,40,121,40
2130,숙박,해뜨는집 (남원),제주특별자치도 서귀포시 남원읍 하신로 31,43,40,36,119,40
3691,음식점,파도소리해녀촌,제주 제주시 우도면 우도해안길 510,52,35,34,121,40
2601,음식점,마마무말가든,제주특별자치도 제주시 아연로 157,45,45,29,119,40
1852,숙박,이런날엔,제주특별자치도 제주시 구좌읍 한동북1길 60,40,39,41,120,40
3096,음식점,아싸횟집,제주특별자치도 서귀포시 동홍중앙로 29-1,48,32,39,119,40
1850,숙박,이디살래,제주특별자치도 서귀포시 안덕면 일주서로 2027,43,49,27,119,40
1978,숙박,중문훼미리리조트,제주특별자치도 서귀포시 소보리당로164번길 83,42,34,45,121,40
1276,숙박,거드락지민박,제주특별자치도 제주시 한림읍 한림로 350,44,41,36,121,40
1815,숙박,오조리비앤비(Ojoribnb),제주특별자치도 서귀포시 성산읍 오조로 42,37,43,41,121,40
2591,음식점,마두천손칼국수,제주특별자치도 제주시 용해로 45,44,37,39,120,40
2474,음식점,독도참치,제주특별자치도 서귀포시 동문로 62-1,37,40,43,120,40
209,관광지,돈대산산림휴양산책로,제주특별자치도 제주시 추자면 예초리 산 67-1,48,38,34,120,40
3811,음식점,현경식당,제주특별자치도 제주시 동광로1길 32,42,46,32,120,40
509,관광지,손방둥이,제주특별자치도 제주시 진군남2길 10-4 101호 손방둥이,46,40,33,119,40
1685,숙박,스마일모텔,제주특별자치도 제주시 연동13길 42,51,32,36,119,40
3249,음식점,용림식당,제주특별자치도 서귀포시 안덕면 사계남로 170-1,41,45,33,119,40
2496,음식점,돌하르방 뚝배기,제주특별자치도 서귀포시 성산읍 일출로 264,36,42,42,120,40
3081,음식점,써니하우스 커피&핫도그,제주특별자치도 서귀포시 안덕면 산방로 212,34,46,40,120,40
545,관광지,신대해안,제주특별자치도 제주시 추자면 예초리 77,41,45,34,120,40
3505,음식점,짱아저씨,제주특별자치도 서귀포시 성산읍 성산중앙로 19,40,39,40,119,40
2942,음식점,서홍정원,제주 서귀포시 솜반천로55번길 12-8,29,45,45,119,40
1558,숙박,바우하우스,제주특별자치도 제주시 구좌읍 문주란로 81,37,32,52,121,40
1729,숙박,아뜨네통나무펜션,제주특별자치도 제주시 애월읍 상하귀길 91,45,52,24,121,40
3718,음식점,풍미독서,제주 제주시 구좌읍 세화합전2길 7,39,47,34,120,40
3722,음식점,피노키오,제주특별자치도 제주시 우도면 우도로 339,40,46,35,121,40
2692,음식점,몽생이,제주특별자치도 제주시 한경면 녹차분재로 628,35,45,39,119,40
2170,숙박,호텔더블유 탑동점,제주특별자치도 제주시 임항로 24,62,33,24,119,40
2204,음식점,73st,제주특별자치도 제주시 해안마을길 73,40,50,31,121,40
2760,음식점,바로족발보쌈 본점,제주특별자치도 제주시 진군1길 25,58,33,28,119,40
2213,음식점,kim여사의밥상,제주특별자치도 서귀포시 안덕면 사계남로216번길 24-68,27,50,44,121,40
2305,음식점,그루브,제주특별자치도 제주시 한림읍 한림로 333,42,42,36,120,40
3854,음식점,흑돼지촌,제주특별자치도 제주시 한림읍 한림상로 62,44,44,33,121,40
1530,숙박,미소게스트하우스,제주특별자치도 제주시 관덕로 41,45,43,31,119,40
2638,음식점,매기의 추억,제주시 한림읍 한림해안로 595,39,43,38,120,40
3542,음식점,청호식당,제주특별자치도 서귀포시 성산읍 온평관전로 94,39,43,39,121,40
3756,음식점,한라식당,제주특별자치도 서귀포시 표선면 성읍정의현로 22번길 8,44,38,38,120,40
2792,음식점,벨라지다,제주특별자치도 서귀포시 안덕면 신화역사로304번길 139,40,52,29,121,40
2276,음식점,과수원집,제주특별자치도 제주시 천수동로 35,32,46,41,119,40
2336,음식점,깜돈 흑돼지,제주특별자치도 제주시 삼무로3길 6,44,39,38,121,40
465,관광지,선족이오름(알선족이),제주특별자치도 제주시 구좌읍 송당리 산 140-2,41,35,43,119,40
3073,음식점,신짜장,제주특별자치도 제주시 중앙로 254,48,36,36,120,40
2322,음식점,길림성,제주특별자치도 제주시 남성로 37,25,48,46,119,40
1613,숙박,비스타케이호텔월드컵,제주특별자치도 서귀포시 김정문화로41번길 10-6,44,38,38,120,40
1597,숙박,브리즈베이호텔,제주특별자치도 서귀포시 성산읍 성산등용로 42,42,41,37,120,40
2296,음식점,귀빈식당,제주특별자치도 제주시 추자면 추자로 14-3,37,41,41,119,40
2987,음식점,소라네집,제주특별자치도 서귀포시 성산읍 환해장성로 631,51,30,40,121,40
2017,숙박,코코스펜션,제주특별자치도 제주시 한림읍 협재2길 26,33,37,46,116,39
1454,숙박,라오체리조트,제주특별자치도 서귀포시 이어도로 763 (강정동),33,44,40,117,39
1399,숙박,더아름다운펜션,제주특별자치도 서귀포시 일주서로 632,32,56,29,117,39
1245,숙박,BK호텔제주,제주특별자치도 서귀포시 칠십리로91번길 12,38,42,38,118,39
2533,음식점,뚱순이 꼬마김밥,제주특별자치도 서귀포시 중앙로62번길 18,34,37,45,116,39
2575,음식점,르에스까르고,제주특별자치도 제주시 월랑로2길 29,39,42,35,116,39
1594,숙박,북촌플레이스,제주특별자치도 제주시 조천읍 일주동로 1435,33,44,40,117,39
2738,음식점,바다는안보여요,제주특별자치도 제주시 구좌읍 종달로5길 31-1,34,44,39,117,39
2112,숙박,하얀언덕,제주특별자치도 서귀포시 표선면 민속해안로 351,42,44,30,116,39
1808,숙박,오션그랜드호텔 (함덕),제주특별자치도 제주시 조천읍 조함해안로 490,44,33,41,118,39
2885,음식점,사해방흑돼지,제주특별자치도 서귀포시 천제연로 263,45,44,28,117,39
2062,숙박,펜션 수망가라,제주특별자치도 서귀포시 남원읍 태수로 667-11,46,36,35,117,39
2924,음식점,서광리123,제주특별자치도 서귀포시 안덕면 중산간서로 1769,48,54,16,118,39
2709,음식점,물질식육식당,제주특별자치도 서귀포시 강정동 4251-8,40,36,42,118,39
2002,숙박,카이리조트,제주특별자치도 제주시 한림읍 협재2길 10,29,50,37,116,39
2609,음식점,마초그릴,제주특별자치도 제주시 중앙로 39,42,43,33,118,39
2000,숙박,추자피싱랜드,제주특별자치도 제주시 추자면 신양4길 18,34,46,38,118,39
2421,음식점,달자카페,제주특별자치도 제주시 애월읍 애월해안로 738,38,48,30,116,39
2791,음식점,베지그랑,서귀포시 효돈로170번길 20,38,47,31,116,39
2798,음식점,병천한가네순대국밥,제주특별자치도 서귀포시 중산간동로 8359,31,50,35,116,39
2515,음식점,두가시가든,제주특별자치도 서귀포시 표선면 하천달산로9번길 96,36,53,29,118,39
2756,음식점,바람이풀에그림그린날,안덕면 감산서로 59,31,45,40,116,39
2705,음식점,문치비 본점,제주특별자치도 서귀포시 신서로32번길 14,53,37,26,116,39
1417,숙박,동굴민박,제주특별자치도 제주시 우도면 영일길 156-12,43,46,29,118,39
2748,음식점,바다제비,제주특별자치도 제주시 한림읍 한림로 640,36,44,38,118,39
1940,숙박,제주이야기펜션,제주특별자치도 제주시 애월읍 유수암평화길 170-2,35,39,43,117,39
1870,숙박,절물길펜션,제주특별자치도 제주시 명림로 10-1,33,33,52,118,39
1687,숙박,스위트모텔,제주특별자치도 제주시 삼무로3길 9,38,45,34,117,39
2313,음식점,그초록,제주특별자치도 제주시 구좌읍 행원로7길 23-16,32,40,46,118,39
1448,숙박,라마다앙코르 서귀포 이스트 호텔,제주특별자치도 서귀포시 서호중로 65,40,42,36,118,39
2273,음식점,공단해장국,제주특별자치도 제주시 복지로 96,44,40,32,116,39
1043,관광지,한남의숙터,제주특별자치도 서귀포시 대정읍 추사로,46,35,36,117,39
2055,숙박,팜밸리리조트,제주특별자치도 서귀포시 중산간서로 193,36,50,32,118,39
3441,음식점,제주의봄,제주특별자치도 서귀포시 신북로 16,36,47,33,116,39
3781,음식점,해녀3대할망네,제주특별자치도 서귀포시 대정읍 마라로 79,52,30,36,118,39
3569,음식점,카페 8,제주특별자치도 제주시 노연로 12,45,41,32,118,39
3666,음식점,탐라화덕피자,제주특별자치도 서귀포시 막숙포로 46,36,32,49,117,39
1131,쇼핑,도예시선,제주특별자치도 제주시 구좌읍 종달논길 36-18,46,32,40,118,39
1145,쇼핑,모이소,제주특별자치도 제주시 신광로8길 14,41,40,36,117,39
3563,음식점,칠돈가 본점,제주특별자치도 제주시 서천길 1,41,42,35,118,39
3101,음식점,아일랜드팩토리 풍류,제주 제주시 관덕로8길 31,42,45,31,118,39
3760,음식점,한라통닭,제주특별자치도 서귀포시 중정로73번길 13,43,43,30,116,39
3365,음식점,잔물결,제주특별자치도 제주시 한림읍 금능길 58-1,52,30,34,116,39
3117,음식점,앙뚜아네트 용담점,제주특별자치도 제주시 서해안로 671,43,44,31,118,39
3192,음식점,옛정의골 식당,제주특별자치도 서귀포시 표선면 중산간동로 4592,37,49,31,117,39
3510,음식점,차롱 해모루,제주특별자치도 서귀포시 남성중로 135,41,34,43,118,39
1621,숙박,비치조아,제주특별자치도 제주시 서흘길 7,29,47,41,117,39
1703,숙박,신등대민박,제주특별자치도 제주시 추자면 추자로 12,26,60,32,118,39
1725,숙박,씨엘블루호텔,제주특별자치도 제주시 서해안로 368-3,38,41,37,116,39
2194,음식점,1080칼국수,제주특별자치도 제주시 서광로13길 3,50,36,30,116,39
2146,숙박,해오름정원,제주특별자치도 제주시 애월읍 상하귀길 98-7,38,37,41,116,39
2616,음식점,만복흑돼지,제주특별자치도 서귀포시 안덕면 산방로 55,32,47,39,118,39
3305,음식점,윌라라,제주특별자치도 서귀포시 성산읍 성산중앙로 33,42,40,36,118,39
2222,음식점,가온해,제주특별자치도 서귀포시 안덕면 난드르로 4,38,45,34,117,39
2828,음식점,봉자살롱,제주특별자치도 제주시 번영로 540 1층,60,44,14,118,39
1544,숙박,바다의향기,제주특별자치도 서귀포시 대정읍 송악관광로177번길 254-6,44,41,32,117,39
1929,숙박,제주에살다,제주특별자치도 서귀포시 성산읍 온평포구로62번길 37,29,42,45,116,39
3319,음식점,은혜전복,제주특별자치도 제주시 애월읍 애월로1길 24-3,46,39,33,118,39
3815,음식점,협재신국수,제주특별자치도 제주시 한림읍 명재로 17,51,36,26,113,38
2428,음식점,대굴대굴구이,제주시 성신로2길 19,48,39,28,115,38
2422,음식점,달콤한휴식,제주특별자치도 제주시 애월읍 천덕로 395,40,39,34,113,38
3179,음식점,연화키친,제주특별자치도 제주시 애월읍 상가로 51,35,49,31,115,38
1511,숙박,메종드판포,제주특별자치도 제주시 한경면 판포중2길 15,26,47,40,113,38
3628,음식점,커피먹는 고냉이,제주특별자치도 서귀포시 성산읍 신양로 103,40,37,38,115,38
3224,음식점,올댓제주,제주특별자치도 제주시 중앙로1길 33 2층,31,44,39,114,38
3850,음식점,흑돈향,제주특별자치도 서귀포시 태평로 58,38,39,36,113,38
2775,음식점,배롱개,제주특별자치도 제주시 구좌읍 해맞이해안로 434,42,37,35,114,38
3603,음식점,카페스노우빈,제주특별자치도 제주시 조천읍 비자림로 702-41,33,49,33,115,38
3595,음식점,카페비몽,제주특별자치도 제주시 구좌읍 비자림로 2279,39,41,35,115,38
3237,음식점,와르다 레스토랑,제주특별자치도 제주시 관덕로8길 24-1,45,40,29,114,38
1185,쇼핑,아코하루,제주특별자치도 제주시 매촌2길 80,40,41,33,114,38
1521,숙박,물고기나무게스트하우스,제주특별자치도 서귀포시 성산읍 중산간동로 4204-14,41,34,38,113,38
3250,음식점,용이식당,제주특별자치도 서귀포시 천지로 40,36,34,45,115,38
1962,숙박,제주항공우주호텔,제주도 서귀포시 안덕면 녹차분재로 216,36,48,30,114,38
2318,음식점,금보가든,제주특별자치도 제주시 조천읍 비자림로 639,40,40,35,115,38
2245,음식점,경미해장국,제주특별자치도 제주시 도령로 39 (노형동) 경미해장국,115,0,0,115,38
1152,쇼핑,바이올가 영어마을점,제주특별자치도 서귀포시 대정읍 에듀시티로 40,35,37,41,113,38
2963,음식점,성산 호랑호랑,제주특별자치도 서귀포시 성산읍 일출로 86 C동,37,42,36,115,38
2839,음식점,부지깽이,제주특별자치도 제주시 광양13길 11-2,32,42,39,113,38
3529,음식점,천지연해물전복뚝배기,제주특별자치도 서귀포시 남성중로 2-3,60,25,29,114,38
2597,음식점,마레벤또,제주특별자치도 제주시 애월읍 애월로1길 10,40,40,35,115,38
2774,음식점,방모루,제주특별자치도 제주시 조천읍 북촌7길 31,35,43,37,115,38
3281,음식점,운해횟집,제주특별자치도 서귀포시 대포로 174,36,38,40,114,38
1733,숙박,아리스토캣펜션,제주특별자치도 제주시 서해안로 518,39,47,29,115,38
1264,숙박,가이아호텔,제주특별자치도 제주시 연동7길 4,38,33,43,114,38
3158,음식점,엉또산장,제주특별자치도 서귀포시 강정동 1599,33,42,38,113,38
1701,숙박,시월애,제주특별자치도 서귀포시 대정읍 무릉사장로 154,40,38,37,115,38
3243,음식점,요요무문,제주특별자치도 제주시 구좌읍 해맞이해안로 1102,45,41,29,115,38
1198,쇼핑,우도아이,제주특별자치도 제주시 우도면 우도해안길 814,47,34,33,114,38
3821,음식점,호끌락다락,제주특별자치도 제주시 조천읍 함덕10길 6,39,34,42,115,38
2020,숙박,콤포스텔라 별들의들판,제주특별자치도 제주시 한림읍 귀덕14길 187-1,36,44,33,113,38
2160,숙박,호도하우스,제주특별자치도 서귀포시 막숙포로 134,35,36,43,114,38
2620,음식점,만세국수,제주특별자치도 제주시 오라로 152,50,39,26,115,38
3058,음식점,시스터필드,제주특별자치도 서귀포시 월드컵로 8,33,39,42,114,38
2309,음식점,그리트커피,제주특별자치도 제주시 인다6길 57,32,53,29,114,38
2097,숙박,하늘정원펜션,제주특별자치도 서귀포시 칠십리로394번길 8-4,25,36,52,113,38
1819,숙박,올레리조트,제주특별자치도 제주시 애월읍 부룡수길 33,39,35,41,115,38
3336,음식점,이조은식당,제주특별자치도 서귀포시 천제연로 97,46,45,24,115,38
2084,숙박,풍차와노을 독채펜션,제주특별자치도 제주시 한경면 한경해안로 474-26,30,51,33,114,38
3016,음식점,수타명가,제주특별자치도 제주시 한림읍 일주서로 5834,39,31,44,114,38
3397,음식점,제주관덕정분식,제주특별자치도 제주시 관덕로8길 7-9,40,34,41,115,38
1995,숙박,추사랑민박,제주특별자치도 제주시 추자면 석두리길 58,35,37,41,113,38
2001,숙박,카사마리나,제주특별자치도 서귀포시 표선면 표선당포로 27,48,33,32,113,38
2669,음식점,모뉴에트,제주특별자치도 제주시 구좌읍 종달동길 23,35,46,32,113,38
2743,음식점,바다어멍,"제주특별자치도 서귀포시 명동로 45 (서귀동, 바원에스클래스) 바다어멍",115,0,0,115,38
2026,숙박,킹스통나무,제주특별자치도 제주시 애월읍 도치돌길 279-1,39,45,30,114,38
1803,숙박,오랑제리펜션,제주특별자치도 서귀포시 법환상로2번길 58,35,45,34,114,38
3757,음식점,한라앤탐,제주특별자치도 서귀포시 남원읍 위미중앙로300번길 8,32,39,42,113,38
2292,음식점,국수장터,제주특별자치도 제주시 동광로 50-1,35,48,30,113,38
1667,숙박,소풍이야기 펜션,제주시 애월읍 애월해안로 832,41,36,36,113,38
1754,숙박,아프리카게스트하우스,제주특별자치도 제주시 조천읍 신흥로2길 33,38,46,29,113,38
1774,숙박,에바다라이더하우스.공방,제주특별자치도 서귀포시 성산읍 고성중앙로 7-8,32,46,35,113,38
2350,음식점,나목도식당,제주특별자치도 서귀포시 표선면 가시로613번길 60,48,33,34,115,38
3343,음식점,인쌩맥주 노형오거리점,제주특별자치도 제주시 다랑곶1길 9 1층,49,39,26,114,38
3356,음식점,일품순두부삼화점,제주특별자치도 제주시 삼봉로2길 54,49,36,29,114,38
2037,숙박,토리코티지카레클린트,제주특별자치도 제주시 애월읍 고내로7길 10-2,37,41,36,114,38
3444,음식점,제주정,제주특별자치도 제주시 일주동로 320,36,42,35,113,38
1345,숙박,넙빌레하우스,제주특별자치도 서귀포시 남원읍 태위로2번길 28,33,50,32,115,38
3056,음식점,시니어손맛 아리랑,제주특별자치도 제주시 동광로2길 7,28,52,34,114,38
3069,음식점,신스버거,제주특별자치도 제주시 한림읍 월령2길 2,44,33,35,112,37
1760,숙박,알앤비타운,제주특별자치도 서귀포시 분토왓로174번길 45,46,33,32,111,37
1368,숙박,다미네민박,제주특별자치도 제주시 추자면 대서6길 46,34,45,32,111,37
1203,쇼핑,인한복,제주특별자치도 제주시 정존3길 1-3,35,45,31,111,37
2646,음식점,메리앤폴,제주시 한림읍 일주서로 5872,35,41,34,110,37
3060,음식점,시즌박스,제주특별자치도 서귀포시 남원읍 태위로 154,39,36,35,110,37
2523,음식점,디 아일렛 라운지,제주특별자치도 서귀포시 안덕면 신화역사로304번길 38,45,39,27,111,37
3604,음식점,카페아오오,제주특별자치도 서귀포시 성산읍 환해장성로 75,50,31,30,111,37
2457,음식점,데미안,제주특별자치도 제주시 한경면 고조로 492-15,31,47,32,110,37
3726,음식점,피자아일랜드,제주특별자치도 서귀포시 성산읍 환해장성로 513,31,38,41,110,37
2675,음식점,모리노코에,제주특별자치도 제주시 구남로2길 30,32,42,37,111,37
1352,숙박,노을담은뜨락,제주특별자치도 서귀포시 대정읍 노을해안로 416,32,35,43,110,37
1356,숙박,뉴그린펜션,제주특별자치도 서귀포시 표선면 표선백사로 121,33,45,34,112,37
3694,음식점,파리바게트 도남점,제주특별자치도 제주시 도남로 53,57,34,19,110,37
288,관광지,묵리해안포구,제주특별자치도 제주시 추자면 추자로 365-1,48,30,32,110,37
3592,음식점,카페백퍼,제주특별자치도 제주시 애월읍 일주서로 7063,47,39,25,111,37
2630,음식점,맛있는집,제주특별자치도 서귀포시 동문로 110 (동홍동),53,36,23,112,37
3632,음식점,커피코알라,제주특별자치도 제주시 과원북4길 71,35,40,35,110,37
2116,숙박,하이제주호텔,제주특별자치도 제주시 한림읍 일주서로 5125,38,40,32,110,37
3682,음식점,토끼문,제주특별자치도 제주시 구좌읍 해맞이해안로 456,40,41,31,112,37
3119,음식점,앙카페,제주특별자치도 서귀포시 대정읍 하모항구로 75,32,39,40,111,37
3516,음식점,참맛나김밥,제주특별자치도 제주시 한라대학로 31,45,36,29,110,37
1790,숙박,엠스테이호텔,제주특별자치도 서귀포시 태평로353번길 14,41,42,29,112,37
3047,음식점,스콘가게 끌림,제주특별자치도 제주시 지석9길 35-1,38,42,30,110,37
1443,숙박,뜨레향 펜션,제주특별자치도 서귀포시 남원읍 하례망장포로 27-8 (하례리) 뜨레향 펜션,38,50,24,112,37
1620,숙박,비지터게스트하우스,제주특별자치도 제주시 오현길 85,47,37,27,111,37
1844,숙박,유러하우스,제주특별자치도 서귀포시 막숙포로 136,35,40,35,110,37
3049,음식점,스테이크 하우스,제주특별자치도 제주시 노연로 12,41,40,31,112,37
1552,숙박,바당정원펜션,제주특별자치도 제주시 한경면 판조로 23,34,41,37,112,37
1569,숙박,뱅디가름게스트하우스,제주특별자치도 서귀포시 성산읍 서성일로1222번길 17,36,50,24,110,37
1574,숙박,베니키아 중문호텔,제주특별자치도 서귀포시 천제연로 166,41,41,30,112,37
1894,숙박,제주디오빌,제주특별자치도 서귀포시 색달로72번길 20,44,38,29,111,37
1745,숙박,아이콘펜션,제주특별자치도 제주시 추자면 신양서길 42,39,38,34,111,37
1738,숙박,아스타호텔,제주특별자치도 제주시 서사로 129,42,36,34,112,37
1679,숙박,숨비아일랜드,제주특별자치도 서귀포시 성산읍 신천서로 91,32,41,38,111,37
1605,숙박,블루마린,제주특별자치도 서귀포시 표선면 민속해안로 349,33,42,37,112,37
1886,숙박,제주나인 부띠끄,제주특별자치도 서귀포시 솔동산로10번길 23,32,47,33,112,37
1445,숙박,라림부띠끄호텔,제주특별자치도 서귀포시 안덕면 대평로 39,55,37,20,112,37
1737,숙박,아모르하우스,제주특별자치도 제주시 구좌읍 해맞이해안로 2060-18,33,45,34,112,37
2796,음식점,별난카페,제주특별자치도 서귀포시 안덕면 녹차분재로 199,32,29,51,112,37
3744,음식점,하와유제주,제주특별자치도 제주시 애월읍 하귀로 85,36,37,39,112,37
1458,숙박,라파로마휴양펜션,제주특별자치도 제주시 한림읍 협재로 62,31,47,32,110,37
2732,음식점,밀리우,제주특별자치도 서귀포시 표선면 민속해안로 537,36,36,39,111,37
1861,숙박,인추자커피앤민박,제주특별자치도 제주시 추자면 추자로 20-1,34,49,29,112,37
1394,숙박,더베이리조트,제주특별자치도 서귀포시 문필로35번길 46,31,46,30,107,36
3653,음식점,키아스마,제주특별자치도 서귀포시 남원읍 태위로 255,29,41,38,108,36
2458,음식점,델리,제주특별자치도 제주시 노연로 12,31,42,34,107,36
1554,숙박,바랑쉬게스트하우스,제주특별자치도 서귀포시 성산읍 환해장성로 496,38,38,32,108,36
3656,음식점,킨포크,제주특별자치도 제주시 노형3길 8,33,39,37,109,36
2864,음식점,비자블라썸,제주특별자치도 제주시 구좌읍 비자림로 2244,32,47,30,109,36
1918,숙박,제주성산아일랜드,제주특별자치도 서귀포시 성산읍 금백조로131번길 176,37,41,30,108,36
1901,숙박,제주마로펜션,제주특별자치도 제주시 한림읍 한림로 414-2,32,52,25,109,36
3187,음식점,예지원,제주특별자치도 서귀포시 천제연로 129,42,40,27,109,36
3729,음식점,픽스커피,제주특별자치도 제주시 신설로11길 2,39,38,31,108,36
1346,숙박,노낭게스트하우스,제주특별자치도 서귀포시 성산읍 섭지코지로 62,37,46,25,108,36
1529,숙박,미소가펜션,제주특별자치도 서귀포시 남원읍 태위로44번길 2-1,30,38,39,107,36
3005,음식점,수다뜰,제주특별자치도 제주시 구좌읍 용눈이오름로 8,34,41,32,107,36
2634,음식점,망고봉봉,제주특별자치도 서귀포시 성산읍 일출로 263,40,45,22,107,36
2653,음식점,멘도롱 cafe,제주특별자치도 서귀포시 대정읍 하모항구로 70,38,34,37,109,36
1840,숙박,웨스티하우스,제주도 서귀포시 안덕면 일주서로 1488번길9,37,41,30,108,36
1659,숙박,소담펜션,제주특별자치도 서귀포시 막숙포로 146,26,42,41,109,36
1115,쇼핑,게른,제주특별자치도 서귀포시 중정로 1,42,34,33,109,36
3469,음식점,종종캐주얼다이닝,제주특별자치도 제주시 과원북2길 66-1,32,42,35,109,36
3803,음식점,행복한시저네,제주특별자치도 서귀포시 막동산로 5-4,39,41,27,107,36
3773,음식점,할머니떡집방앗간,제주특별자치도 서귀포시 중앙로79번길 12,51,39,17,107,36
1127,쇼핑,당근가게,제주특별자치도 제주시 서광로5길 4,33,37,37,107,36
2875,음식점,뽀요요 카페,제주특별자치도 제주시 우도면 우도해안길 128,32,30,45,107,36
3454,음식점,제주판타스틱버거,제주특별자치도 서귀포시 표선면 토산중앙로15번길 6,40,38,30,108,36
2544,음식점,라포레사려니,제주시 조천읍 비자림로 685-3,37,42,30,109,36
1820,숙박,올레스테이,제주특별자치도 서귀포시 중정로 22,37,41,30,108,36
1827,숙박,외돌개나라,제주특별자치도 서귀포시 남성로 122,29,46,33,108,36
2514,음식점,돼지촌,제주특별자치도 제주시 원노형남1길 28,36,44,29,109,36
1837,숙박,월정소랑,제주특별자치도 제주시 구좌읍 월정1길 79-3,38,42,28,108,36
1973,숙박,중문빌리지,제주특별자치도 서귀포시 예래로 270,38,41,28,107,36
1921,숙박,제주스테이비우다,제주특별자치도 서귀포시 색달중앙로121번길 45,26,41,41,108,36
3141,음식점,어머니빵집,제주특별자치도 제주시 도령로 103,46,37,24,107,36
3238,음식점,와토커피,제주특별자치도 서귀포시 대정읍 동일하모로 238,39,39,31,109,36
2187,숙박,휘슬락호텔,제주특별자치도 제주시 서부두2길 26,30,52,25,107,36
3106,음식점,안녕구움,제주특별자치도 제주시 한경면 고산로 49 1층,35,40,33,108,36
2521,음식점,듀포레,제주특별자치도 제주시 서해안로 579,34,44,31,109,36
2753,음식점,바라나시 책골목,제주시 동한두기길 35-2,40,44,23,107,36
2209,음식점,M1971엠브릿지,"제주특별자치도 서귀포시 대정읍 최남단해안로 128, M1971",46,41,20,107,36
2200,음식점,24시뼈다귀탕동홍점,제주특별자치도 서귀포시 동홍남로 43,50,37,22,109,36
2118,숙박,한담풍경하우스,제주특별자치도 제주시 애월읍 애월로 6,52,28,29,109,36
3028,음식점,순희뽀글이,제주특별자치도 제주시 공설로 27-1 (오라일동),32,40,36,108,36
1298,숙박,그린나래,제주도 서귀포시 성산읍 서성일로 615,46,34,29,109,36
1957,숙박,제주포시즌호텔,제주특별자치도 제주시 원노형3길 19,35,38,35,108,36
1505,숙박,메모리 인 제주 펜션,제주특별자치도 서귀포시 염돈로 93-14,39,32,37,108,36
3607,음식점,카페유주,제주특별자치도 제주시 한림읍 한림상로 17,39,43,26,108,36
1299,숙박,그린민박,제주특별자치도 제주시 추자면 대서6길 6-5,42,33,34,109,36
2983,음식점,세평맛집,제주특별자치도 제주시 구좌읍 세평항로 1,30,49,29,108,36
2528,음식점,떡하니,제주특별자치도 제주시 구좌읍 행원로9길 9-5,34,29,44,107,36
1181,쇼핑,쓸모있는 생활잡화점,제주특별자치도 제주시 인다3길 5,25,38,44,107,36
2790,음식점,베이크샵스니프,제주특별자치도 서귀포시 신서귀로 32,40,43,26,109,36
2233,음식점,강해일횟집,제주특별자치도 서귀포시 표선면 표선당포로 14,43,37,27,107,36
2895,음식점,산책하우스,제주특별자치도 제주시 애월읍 고내로7길 49,37,40,32,109,36
3260,음식점,우도자연,제주특별자치도 제주시 우도면 우도해안길 602,37,39,32,108,36
1273,숙박,갤러리민박,제주특별자치도 제주시 추자면 신양서길 42-2,35,39,33,107,36
2582,음식점,리치망고 협재점,제주특별자치도 제주시 한림읍 한림로 482,37,48,24,109,36
1699,숙박,슴게스트하우스 제주공항점,제주특별자치도 제주시 서광로5길 2-2,33,51,25,109,36
3573,음식점,카페 라라라,제주특별자치도 제주시 구좌읍 해맞이해안로 1430,43,40,26,109,36
2782,음식점,버거307,제주특별자치도 제주시 조천읍 조함해안로 504,39,33,35,107,36
3582,음식점,카페더라이트,제주특별자치도 서귀포시 성산읍 한도로 269,39,39,30,108,36
2897,음식점,산호반점,제주특별자치도 제주시 우도면 우도해안길 252,38,37,34,109,36
2894,음식점,산지해장국,제주특별자치도 제주시 임항로 34,50,29,25,104,35
1518,숙박,몽돌바당,제주특별자치도 제주시 내도3길 10,33,38,34,105,35
3083,음식점,썸의시작,제주특별자치도 제주시 애월읍 애월해안로 570-1,37,45,22,104,35
3082,음식점,썬셋클리프,제주특별자치도 제주시 애월읍 애월로1길 19-8,37,47,21,105,35
1379,숙박,달빛고운펜션,제주특별자치도 제주시 구좌읍 월정7길 52-1,26,44,36,106,35
3087,음식점,아따블르,제주특별자치도 제주시 조천읍 북촌11길 15-16,37,36,31,104,35
3792,음식점,해와달그리고섬,제주특별자치도 제주시 우도면 우도해안길 946,36,32,36,104,35
3352,음식점,일탈흑돼지,제주특별자치도 서귀포시 성산읍 성산등용로 78,36,39,30,105,35
1221,쇼핑,책약방,제주특별자치도 제주시 구좌읍 종달로5길 11,34,34,36,104,35
2287,음식점,국수냐 국밥이냐,제주특별자치도 서귀포시 김정문화로 39,36,35,33,104,35
2277,음식점,곽지BAR다,제주특별자치도 제주시 애월읍 곽지1길 18,29,43,32,104,35
2993,음식점,손맛촌,제주특별자치도 제주시 조천읍 비자림로 661,48,28,29,105,35
1435,숙박,디스이즈핫,제주특별자치도 제주시 구좌읍 하도15길 153-5,38,43,24,105,35
1267,숙박,간드락게스트하우스,제주특별자치도 제주시 간월동로 12,40,37,29,106,35
2827,음식점,봉이네식당,제주특별자치도 제주시 추자면 신양2길 39,40,32,34,106,35
3842,음식점,황토기와집,제주특별자치도 서귀포시 일주서로 1102,32,37,35,104,35
1262,숙박,가산토방,제주특별자치도 서귀포시 인정오름로86번길 3,35,42,28,105,35
3144,음식점,어멍,제주특별자치도 제주시 조천읍 신북로 577대명리조트 B동 1층,39,38,27,104,35
2914,음식점,삼일해장국,제주특별자치도 제주시 애월읍 하귀9길 14,59,33,14,106,35
1257,숙박,cafe말/개스트하우스 말,제주특별자치도 서귀포시 이어도로 450,46,31,28,105,35
1473,숙박,로그빌리지 펜션,제주특별자치도 서귀포시 표선면 일주동로 5944,40,30,35,105,35
1311,숙박,김군아미고게스트하우스,제주특별자치도 제주시 애월읍 애월해안로 670,34,35,35,104,35
3819,음식점,형돈,제주특별자치도 제주시 구남로 22,31,37,37,105,35
1504,숙박,머무름민박,제주특별자치도 제주시 한림읍 명재로 61-5,28,49,29,106,35
1491,숙박,리틀해녀,제주특별자치도 제주시 용마로3길 10-7,26,52,26,104,35
1347,숙박,노닐다 게스트하우스,제주특별자치도 제주시 우도면 우도해안길 84-3,39,28,38,105,35
2998,음식점,솜반내풍경,제주특별자치도 서귀포시 서홍로 60,26,45,34,105,35
3539,음식점,청춘테이블,제주특별자치도 제주시 동문로 89,28,49,27,104,35
1321,숙박,꿈꾸는바다,제주도 제주시 도두항서길 65,40,44,20,104,35
3290,음식점,원항아리칼국수보쌈,제주특별자치도 제주시 복지로1길 11,31,50,25,106,35
1889,숙박,제주도연게스트하우스,제주특별자치도 제주시 한림읍 일주서로 5673,37,36,31,104,35
3805,음식점,허벅식당,제주특별자치도 제주시 구좌읍 세평항로 26,38,37,30,105,35
3194,음식점,오끼416갤러리,제주특별자치도 서귀포시 남원읍 태수로358번길 3-1,42,37,27,106,35
1586,숙박,볼몽지엥하우스,제주특별자치도 서귀포시 보목포로1번길 10,29,37,39,105,35
1626,숙박,뽀요요펜션,제주특별자치도 제주시 우도면 우도해안길 128,38,39,29,106,35
3649,음식점,크래커스 한경점,제주특별자치도 제주시 한경면 낙수로 1,30,43,33,106,35
2215,음식점,가든이다,제주특별자치도 서귀포시 중문상로 86,39,34,32,105,35
1663,숙박,소섬바당,제주특별자치도 제주시 우도면 우도로 190,29,45,30,104,35
2338,음식점,꼬꼬닭한마리,제주특별자치도 서귀포시 안덕면 녹차분재로 59번길 6,45,29,30,104,35
2689,음식점,몰질식육식당,제주특별자치도 서귀포시 이어도로 598,35,37,33,105,35
1541,숙박,바다스케치,제주특별자치도 서귀포시 안덕면 사계남로216번길 52,43,37,26,106,35
1899,숙박,제주리시온관광호텔,제주특별자치도 서귀포시 표선면 표선동서로 263,48,52,6,106,35
2678,음식점,모모제이,제주특별자치도 제주시 인다8길 36-1,35,35,34,104,35
1618,숙박,비자낭달집,제주특별자치도 제주시 구좌읍 비자림로 2279,34,38,32,104,35
3291,음식점,월드컵흑돼지,제주특별자치도 서귀포시 월드컵로 74,41,32,31,104,35
3359,음식점,임순이네,제주특별자치도 제주시 애월읍 곽지1길 26-7,40,35,29,104,35
1871,숙박,제니빌펜션,제주도 서귀포시 남원읍 태위로 604-15,25,46,33,104,35
1771,숙박,에덴통나무빌리지,제주특별자치도 제주시 한경면 명이1길 32,39,39,27,105,35
3503,음식점,짜장면시키신분 마라점,제주특별자치도 서귀포시 대정읍 가파로 131,36,39,30,105,35
2078,숙박,폴라리스인제주,제주특별자치도 제주시 애월읍 유수암동3길 45,38,41,25,104,35
2048,숙박,파밀리아호텔,제주특별자치도 서귀포시 대포동서로 63-20,35,47,24,106,35
1749,숙박,아침해변,제주특별자치도 제주시 조천읍 조함해안로 76-9,41,38,25,104,35
2031,숙박,태성민박,제주특별자치도 제주시 추자면 추자로 54-1,31,41,34,106,35
644,관광지,예초리포구,제주특별자치도 제주시 추자면 추자로 753,33,39,32,104,35
2014,숙박,코업시티호텔성산,제주특별자치도 서귀포시 성산읍 성산등용로 28,25,41,39,105,35
2008,숙박,케이관광호텔제주,제주특별자치도 제주시 연동3길 10,55,32,18,105,35
1855,숙박,이쁜새이쁘게노래하고펜션,제주특별자치도 제주시 한림읍 협재로 68-5,38,36,31,105,35
2937,음식점,서우봉가든,제주특별자치도 제주시 조천읍 함대로 78,32,42,28,102,34
1987,숙박,청정고을민박,제주특별자치도 제주시 추자면 대서1길 6,35,41,27,103,34
2249,음식점,고객식당,제주특별자치도 제주시 관덕로14길 20,34,30,37,101,34
1989,숙박,체이슨호텔 더 스마일,제주특별자치도 서귀포시 신서로48번길 50,30,41,30,101,34
3651,음식점,큰돈가 중문점,제주특별자치도 서귀포시 천제연로 89,36,41,26,103,34
2679,음식점,모슬포에서,서귀포시 대정읍 영서중로13번길 9-9,36,36,31,103,34
1553,숙박,바람돌이하우스,제주특별자치도 제주시 구좌읍 행원로5길 35-5,34,42,27,103,34
2811,음식점,보영반점,제주특별자치도 제주시 한림읍 한림로 692-1,32,40,29,101,34
3527,음식점,천보식당,제주특별자치도 서귀포시 중앙로89번길 13,30,42,31,103,34
1849,숙박,유탑유블레스호텔,제주특별자치도 제주시 조천읍 조함해안로 502,38,31,32,101,34
1547,숙박,바다풍경펜션,제주특별자치도 제주시 애월읍 애월해안로 923,38,31,33,102,34
2981,음식점,세자매식당,제주특별자치도 서귀포시 신서귀로 11 민우상가 102호(법환동),29,25,49,103,34
2218,음식점,가산토방 식당,제주특별자치도 서귀포시 인정오름로 86번길 3,26,40,36,102,34
2813,음식점,복단지식당,제주특별자치도 제주시 한림읍 한림북동길 26,34,36,33,103,34
2577,음식점,리듬,제주특별자치도 제주시 무근성7길 11,33,35,33,101,34
1582,숙박,볕들이펜션,제주특별자치도 서귀포시 성산읍 일출로 284-4,28,38,37,103,34
3697,음식점,파스쿠찌 도남점,제주특별자치도 제주시 연북로 444,35,34,33,102,34
2469,음식점,도렐,제주특별자치도 서귀포시 성산읍 동류암로 20,50,31,20,101,34
2700,음식점,문게야,제주특별자치도 제주시 동광로23길 23,35,35,31,101,34
2718,음식점,미복빈대떡,제주시 신대로16길 49,30,43,29,102,34
2576,음식점,르토아 베이스먼트,제주특별자치도 제주시 구좌읍 해맞이해안로 1226,38,34,29,101,34
2013,숙박,코시롱게스트하우스,제주특별자치도 서귀포시 성산읍 성산중앙로37번길 1,34,37,30,101,34
2899,음식점,산호풍경,제주특별자치도 제주시 우도면 우도해안길 252,40,35,26,101,34
2870,음식점,빠라빠빵,제주특별자치도 제주시 서해안로 472-2,34,42,26,102,34
2712,음식점,미나리식당,제주특별자치도 서귀포시 중앙로59번길 11,47,29,26,102,34
2849,음식점,블랙포엠,제주특별자치도 제주시 조천읍 조함해안로 476-1,36,40,26,102,34
2921,음식점,생이소리,제주특별자치도 제주시 명림로 231,32,39,32,103,34
1438,숙박,땅콩펜션,제주특별자치도 제주시 우도면 영일길 156-12,34,39,30,103,34
2427,음식점,대광장식당,제주특별자치도 서귀포시 중앙로 79,44,31,27,102,34
1240,쇼핑,현승이네농장,제주특별자치도 제주시 애월읍 신엄리 16,32,42,29,103,34
3027,음식점,순풍해장국,제주특별자치도 제주시 일주동로 355,37,34,30,101,34
1333,숙박,나무향기펜션,제주특별자치도 제주시 도리로 62,37,40,25,102,34
1831,숙박,우도올레펜션,제주특별자치도 제주시 우도면 전흘길 42,30,41,32,103,34
2300,음식점,그대와함께라면,서귀포시 성산읍 환해장성로 929,33,41,28,102,34
3766,음식점,한성식당,제주특별자치도 서귀포시 성산읍 일출로 287,39,33,30,102,34
1500,숙박,마린포트리조트,제주특별자치도 서귀포시 이어도로 744,26,44,31,101,34
2144,숙박,해안풍경펜션,제주특별자치도 제주시 신사수2길 6,30,31,42,103,34
1814,숙박,오시록헌펜션,제주특별자치도 제주시 한림읍 금능6길 8,33,44,26,103,34
1833,숙박,우리두리게스트하우스,제주특별자치도 서귀포시 표선면 민속해안로119번길 10-1,32,45,26,103,34
1672,숙박,쇠소깍섬도리왓펜션,서귀포시 효돈순환로 217-3,36,40,27,103,34
2117,숙박,하쿠나마타타게스트하우스,제주특별자치도 제주시 애월읍 고내북동길 17,28,46,27,101,34
1489,숙박,리치망고펜션,제주특별자치도 제주시 우도면 우도해안길 808,32,37,33,102,34
3262,음식점,우도해광식당,제주특별자치도 제주시 우도면 하고수길 69,34,36,33,103,34
1770,숙박,에너벨리민박,제주특별자치도 제주시 한림읍 한림로 356,38,32,31,101,34
1186,쇼핑,아트앤제주,제주특별자치도 제주시 월광로 135,28,36,37,101,34
2175,숙박,호텔아로하,제주특별자치도 서귀포시 성산읍 성산등용로 40,45,36,21,102,34
2022,숙박,쿨쿨하우스,제주특별자치도 서귀포시 동홍로262번길 62,34,37,31,102,34
2367,음식점,너는파라다이스길리,제주특별자치도 제주시 구좌읍 월정1길 65,26,34,41,101,34
3146,음식점,어반르토아,제주특별자치도 제주시 구남동5길 36,32,33,36,101,34
3306,음식점,유기농커피 카페다,제주특별자치도 제주시 조천읍 신촌북3길 4-7,40,35,27,102,34
1237,쇼핑,한마음한라봉,제주특별자치도 제주시 애월읍 애월해안로 32,41,21,40,102,34
3257,음식점,우도아름다운소풍,제주특별자치도 제주시 우도면 우도해안길 446,35,42,26,103,34
3468,음식점,종이시계 카페,제주특별자치도 제주시 애월읍 애월해안로 899,39,34,29,102,34
2605,음식점,마쇼,제주특별자치도 제주시 신성로13길 26,39,32,29,100,33
2635,음식점,망고홀릭 법환점,제주특별자치도 서귀포시 막숙포로 83,33,36,31,100,33
2135,숙박,해바라기 펜션,제주특별자치도 서귀포시 표선면 일주동로6285번길 13-12,25,43,30,98,33
3363,음식점,자연으로,제주특별자치도 서귀포시 성산읍 중산간동로 4217,32,37,31,100,33
3118,음식점,앙뚜아네트 탑동점,제주특별자치도 제주시 중앙로 13,34,35,30,99,33
3419,음식점,제주삼다국수,제주특별자치도 서귀포시 김정문화로 59-1,37,28,35,100,33
1904,숙박,제주메이플호텔,제주특별자치도 제주시 원노형3길 41,37,38,24,99,33
1812,숙박,오션트리,제주특별자치도 서귀포시 월드컵로 188,21,40,37,98,33
1937,숙박,제주우리집펜션,제주특별자치도 제주시 한경면 청수동3길 1,35,34,29,98,33
2940,음식점,서유기마라탕,제주특별자치도 서귀포시 안덕면 신화역사로304번길 38 F005동 1층,53,26,21,100,33
1430,숙박,뒹글하우스,제주특별자치도 제주시 구좌읍 월정7길 28-6,22,53,24,99,33
2556,음식점,로맨틱하드보일드,제주특별자치도 제주시 애월읍 금성5길 44,33,35,31,99,33
3234,음식점,옵써빵집,제주특별자치도 서귀포시 표선면 표선동서로 240,32,35,31,98,33
2128,숙박,해담은스파빌,제주특별자치도 서귀포시 안덕면 사계북로 157-15,28,41,29,98,33
1478,숙박,롯데리조트제주 아트빌라스,제주특별자치도 서귀포시 색달중앙로252번길 124,99,0,0,99,33
1323,숙박,꿈꾸는정원,제주특별자치도 제주시 조천읍 함덕서4길 47,38,30,32,100,33
1561,숙박,밧돌 게스트하우스,제주특별자치도 제주시 구좌읍 비자림로 1771,35,30,35,100,33
2771,음식점,밤낮가온,제주특별자치도 제주시 도남로 24,29,39,30,98,33
3206,음식점,오르다키친,제주시 애월읍 애월해안로 672,37,36,25,98,33
2786,음식점,법환어촌계횟집,제주특별자치도 서귀포시 막숙포로 62,41,34,24,99,33
3041,음식점,스모크하우스인구억,제주특별자치도 서귀포시 대정읍 보성구억로 223,49,23,26,98,33
3496,음식점,진대감12제주,제주특별자치도 제주시 광평동로 45,40,33,25,98,33
1694,숙박,스토리인제주게스트하우스,제주특별자치도 제주시 중앙로12길 5,36,30,33,99,33
2831,음식점,봉플라봉뱅,제주특별자치도 제주시 문송1길 6-1 정인하우스 1층,26,34,38,98,33
1234,쇼핑,한라꽃방,제주특별자치도 서귀포시 이중섭로 34,34,36,29,99,33
2129,숙박,해돋는마을,제주특별자치도 서귀포시 성산읍 한도로 116-1,37,41,21,99,33
1515,숙박,몬딱게스트하우스,제주특별자치도 제주시 구좌읍 세화서길 7-31,32,40,27,99,33
3847,음식점,훈남횟집,제주특별자치도 제주시 조천읍 함덕13길 7,42,22,36,100,33
2684,음식점,모퉁이스낵,제주특별자치도 서귀포시 성산읍 일출로 270-2,27,39,32,98,33
2206,음식점,And유Cafe,제주특별자치도 제주시 한림읍 한림로 518,39,36,24,99,33
3786,음식점,해뜨는식당,제주특별자치도 서귀포시 성산읍 한도로 269,38,34,27,99,33
2971,음식점,성신흑돼지,제주특별자치도 서귀포시 표선면 민속해안로 580,30,43,27,100,33
3430,음식점,제주약수터 본점,제주특별자치도 서귀포시 중앙로 35,47,29,22,98,33
1728,숙박,아델리아빌,제주특별자치도 제주시 내도9길 8-15,27,39,34,100,33
3315,음식점,육갑봉,제주특별자치도 제주시 신설로11길 2-9,42,34,23,99,33
3698,음식점,파시랑,제주특별자치도 서귀포시 솔동산로 15 (서귀동),32,38,29,99,33
3084,음식점,쓰쓰카페,제주특별자치도 제주시 한경면 성굴로 34-6,26,43,30,99,33
1746,숙박,아인피플호텔,제주특별자치도 제주시 논세길 51,36,36,27,99,33
2225,음식점,간이옥돔역,서귀포시 남원읍 남태해안로 484,32,35,33,100,33
2913,음식점,삼일식당,제주특별자치도 제주시 한림읍 한림상로 92,38,35,27,100,33
1753,숙박,아트모텔,제주특별자치도 제주시 신대로20길 48,32,41,26,99,33
3292,음식점,월령203,제주특별자치도 제주시 한림읍 한림로 16-3,30,35,34,99,33
3149,음식점,어사촌도야지,제주특별자치도 제주시 애월읍 천덕로 440-6,43,28,28,99,33
1766,숙박,언니게스트하우스,제주특별자치도 제주시 구좌읍 대수길 10-12,38,34,28,100,33
3044,음식점,스시우다,제주특별자치도 제주시 용마로 30,37,35,26,98,33
1418,숙박,동막골게스트하우스,제주특별자치도 서귀포시 안덕면 서광서문로 55-7,40,41,19,100,33
2080,숙박,퐁낭하우스제주,제주특별자치도 제주시 한림읍 대림12길 60-4 (대림리),34,32,34,100,33
2303,음식점,그러므로,제주특별자치도 제주시 구남동6길 45,31,36,33,100,33
1260,숙박,가름게스트하우스,제주특별자치도 서귀포시 법환하로9번길 10,29,40,30,99,33
3524,음식점,책다방,제주시 구좌읍 월정1길 70-1,28,34,37,99,33
1721,숙박,씨스테이호텔,제주특별자치도 제주시 애월읍 애월해안로 255,33,37,30,100,33
3689,음식점,통돌이돈통가,제주특별자치도 제주시 우령2길 52,31,38,30,99,33
2861,음식점,비올레제주,제주특별자치도 제주시 한림읍 한림로 510,30,27,41,98,33
1428,숙박,두리안펜션,제주특별자치도 서귀포시 남원읍 태위로 551-3 두리안펜션,37,31,30,98,33
2193,숙박,힐링캠프펜션,서귀포시 남원읍 위미항구로 96,33,37,28,98,33
2027,숙박,타미우스골프앤빌리지,제주특별자치도 제주시 애월읍 화전길 201,31,34,34,99,33
1950,숙박,제주파인비치카라반,제주특별자치도 서귀포시 남원읍 태위로 976-10,25,42,30,97,32
1358,숙박,뉴아일랜드호텔,제주특별자치도 제주시 연동6길 17,39,39,18,96,32
3618,음식점,카페하물,제주특별자치도 제주시 애월읍 애월해안로 58,30,31,35,96,32
2817,음식점,본가,제주특별자치도 제주시 도남로 103,37,29,31,97,32
2253,음식점,고래라면 신화역사점,제주특별자치도 서귀포시 안덕면 신화역사로304번길 38,43,34,19,96,32
2157,숙박,헤세드하우스,제주특별자치도 서귀포시 표선면 가마행남로 42,22,33,42,97,32
1304,숙박,그림그리는펜션,제주도 서귀포시 성산읍 금백조로131번길 181,36,37,24,97,32
3208,음식점,오르미,제주특별자치도 제주시 서회천길 33,29,31,37,97,32
1286,숙박,골든비치,제주도 제주시 서해안로 486-3,36,31,29,96,32
2681,음식점,모실래기해녀해물촌,제주특별자치도 제주시 우도면 우도해안길 248,29,37,29,95,32
1748,숙박,아침의향기,제주특별자치도 서귀포시 색달중앙로 122,29,39,28,96,32
3055,음식점,시나르,제주특별자치도 제주시 조천읍 중산간동로 929,31,32,34,97,32
2357,음식점,남또리,제주특별자치도 제주시 애월읍 애월해안로 384,37,29,29,95,32
2228,음식점,감산우리가든,제주특별자치도 서귀포시 안덕면 일주서로 1558,37,39,20,96,32
2319,음식점,금뽕똘향토음식점,제주특별자치도 제주시 번영로 500 (봉개동),32,35,30,97,32
1225,쇼핑,큰손상회,제주특별자치도 제주시 구좌읍 행원로1길 26-2,36,23,36,95,32
3608,음식점,카페이시도르,제주특별자치도 제주시 한림읍 금악북로 353,33,35,28,96,32
2626,음식점,말이,제주특별자치도 제주시 구좌읍 세화1길 40,31,32,33,96,32
3498,음식점,진미네식당,제주특별자치도 제주시 수덕5길 42,33,29,33,95,32
2405,음식점,다올김밥분식,제주특별자치도 제주시 남녕로 48,51,29,16,96,32
2067,숙박,펜션형민박꿈꾸는숲,제주특별자치도 서귀포시 태평로205번길 43-7,27,40,29,96,32
2074,숙박,포시즌펜션,제주특별자치도 서귀포시 칠십리로285번길 3,31,33,32,96,32
3828,음식점,홍삼흑돼지,제주특별자치도 서귀포시 표선면 표선당포로 16-6,28,36,31,95,32
2266,음식점,고향향토장터,제주특별자치도 제주시 추자면 추자로 576,28,41,26,95,32
1967,숙박,조은민박,제주특별자치도 제주시 추자면 대서4길 6,29,36,30,95,32
2375,음식점,노을과 어울림 카페,제주특별자치도 서귀포시 대정읍 노을해안로 638-2,33,38,25,96,32
3092,음식점,아랑,"제주특별자치도 제주시 선덕로 5길 25(연동, 연미주택)",36,31,30,97,32
3225,음식점,올디벗구디,제주특별자치도 서귀포시 일주서로 330,27,42,28,97,32
1528,숙박,미르빌펜션,제주특별자치도 서귀포시 안덕면 사계로114번길 87,30,33,33,96,32
1565,숙박,백악관민박,제주특별자치도 제주시 우도면 우도해안길 816,31,33,32,96,32
2765,음식점,바우네나주곰탕 삼화점,제주특별자치도 제주시 삼봉로 47,47,30,18,95,32
3272,음식점,우무깨식당,제주특별자치도 제주시 우도면 우도해안길 356,28,33,34,95,32
2767,음식점,바위소리,제주특별자치도 제주시 우도면 우도해안길 1112,27,38,32,97,32
2602,음식점,마마식당,제주특별자치도 제주시 추자면 추자로 36,21,43,32,96,32
2750,음식점,바당꺼몬딱,제주특별자치도 제주시 우도면 우도해안길 144,24,30,42,96,32
3011,음식점,수애기베이커리,제주특별자치도 서귀포시 대정읍 동일하모로98번길 48-59,40,31,24,95,32
1149,쇼핑,미카의달콤한작업실,제주특별자치도 서귀포시 안덕면 사계남로84번길 4,37,31,27,95,32
1887,숙박,제주나인리조트,제주특별자치도 제주시 해안마을북길 14-5,29,40,28,97,32
2710,음식점,물회영해초영,제주 제주시 우도면 우도해안길 46,25,41,29,95,32
2956,음식점,섭지향,제주특별자치도 서귀포시 표선면 표선동서로 195,28,34,35,97,32
1381,숙박,달자펜션,제주특별자치도 제주시 애월읍 애월해안로 738,34,39,24,97,32
2345,음식점,꽃향유,제주시 애월읍 고하상로 101,31,46,18,95,32
1384,숙박,달콤한아침,제주특별자치도 제주시 구좌읍 행원로 35-9,32,37,27,96,32
3737,음식점,하르방밀면(운동장점),제주특별자치도 제주시 공설로 53,37,39,21,97,32
2106,숙박,하루앤하루,제주특별자치도 제주시 조천읍 조천7길 12,34,33,30,97,32
3831,음식점,화북빵굽는사람들,제주특별자치도 제주시 일주동로 233,45,23,29,97,32
2111,숙박,하얀산호민박,제주특별자치도 제주시 우도면 우도해안길 144,33,31,32,96,32
2494,음식점,돌코롬허니,제주특별자치도 제주시 구좌읍 김녕로 110,30,39,28,97,32
1903,숙박,제주머무리,제주특별자치도 서귀포시 안덕면 평화로 437-10,31,42,24,97,32
3392,음식점,제일식당,제주특별자치도 제주시 추자면 추자로 16-2,29,33,35,97,32
2920,음식점,생원전복,제주특별자치도 서귀포시 안덕면 산방로 7,31,39,27,97,32
1516,숙박,몬딱쉼터,제주특별자치도 서귀포시 토평로 137,35,34,26,95,32
1788,숙박,엠버하우스,제주특별자치도 제주시 애월읍 애월해안로 400,29,39,28,96,32
2432,음식점,대박국수,제주특별자치도 제주시 신대로14길 5,36,35,25,96,32
1119,쇼핑,그꽃,제주특별자치도 제주시 구좌읍 월정1길 55,45,30,22,97,32
2826,음식점,봉봉커피,제주특별자치도 제주시 우도면 우도해안길 630,28,37,32,97,32
1256,숙박,be Lazy B&B,제주특별자치도 서귀포시 남원읍 위미해안로129번길 17,35,39,22,96,32
1656,숙박,셋째날,제주특별자치도 서귀포시 하신상로 273-7,35,34,26,95,32
2311,음식점,그림상회화덕피자,제주특별자치도 서귀포시 표선면 중산간동로5570번길 9,28,34,33,95,32
3163,음식점,에오마르,제주특별자치도 제주시 선사로8길 13-6,27,38,31,96,32
3128,음식점,애월바베,제주특별자치도 제주시 원노형10길 32,23,35,38,96,32
1874,숙박,제이앤클로이,제주특별자치도 서귀포시 대정읍 무릉중앙로 203,31,39,26,96,32
3372,음식점,저팔계깡통연탄구이,제주특별자치도 제주시 조천읍 신북로 531,40,31,26,97,32
1828,숙박,용두암빌리지,제주특별자치도 제주시 용마서1길 27-5,26,44,27,97,32
1639,숙박,삼해인관광호텔,제주특별자치도 제주시 도령로 108,36,35,26,97,32
1829,숙박,우도사랑,제주특별자치도 제주시 우도면 우목길 82-2,29,42,24,95,32
2297,음식점,귤따고 레드향갈고,제주시 애월읍 애월해안로 274,25,40,32,97,32
3747,음식점,하우스레서피,제주특별자치도 제주시 한림읍 일주서로 5892,38,30,27,95,32
3790,음식점,해비치불턱,제주특별자치도 서귀포시 표선면 민속해안로 384,31,43,19,93,31
3596,음식점,카페빠네띠에,제주특별자치도 제주시 신설로9길 25,32,36,24,92,31
2177,숙박,호텔제이엠,제주특별자치도 제주시 삼무로1길 10-7,33,30,29,92,31
2333,음식점,까떼커피,제주특별자치도 서귀포시 표선면 민속해안로 594,37,35,20,92,31
2413,음식점,달리맨,제주특별자치도 서귀포시 성산읍 환해장성로 950,28,33,31,92,31
3157,음식점,엉덩물,제주특별자치도 제주시 성두길 7-7,33,32,28,93,31
3626,음식점,커피로카,제주특별자치도 제주시 고마로 86,21,38,35,94,31
3795,음식점,해월향,제주특별자치도 서귀포시 성산읍 고성오조로 33,33,37,24,94,31
1802,숙박,오누게스트하우스,제주특별자치도 제주시 애월읍 애월로2길 7,37,34,23,94,31
1488,숙박,리버풀펜션,제주특별자치도 제주시 도두봉6길 13,29,42,21,92,31
2054,숙박,팔도민박,제주특별자치도 서귀포시 대정읍 마라로 109,35,25,32,92,31
1712,숙박,썬라이즈호텔,제주특별자치도 서귀포시 중문관광로 310,32,38,23,93,31
3152,음식점,어전횟집,제주특별자치도 서귀포시 대정읍 최남단해안로 31,35,28,31,94,31
2958,음식점,성광식당,제주특별자치도 서귀포시 일주동로 8184 (신효동),29,32,32,93,31
1695,숙박,스토리하우스펜션,제주특별자치도 제주시 도리중길 37,23,39,32,94,31
2368,음식점,너와의 첫여행,제주특별자치도 제주시 애월읍 장소로 16,42,36,14,92,31
3501,음식점,진양해장국,제주특별자치도 제주시 지석10길 13,31,31,32,94,31
1666,숙박,소풍BnB,제주특별자치도 서귀포시 호근남로 82,24,38,32,94,31
3340,음식점,인더오조,제주특별자치도 서귀포시 성산읍 해맞이해안로 2768,29,33,31,93,31
3686,음식점,토향,제주특별자치도 제주시 한경면 연명로 372,39,29,26,94,31
2561,음식점,로치아 커피로스터스,제주특별자치도 제주시 도공로 53,31,38,23,92,31
2426,음식점,대관원,제주특별자치도 제주시 신대로13길 3,8,47,39,94,31
2424,음식점,담다,제주특별자치도 제주시 한림읍 협재4길 8,24,30,38,92,31
3623,음식점,커먼브릭,제주특별자치도 제주시 월랑로 9,35,33,24,92,31
3276,음식점,우유부단 크림공작소,제주특별자치도 제주시 관덕로8길 7-5,29,30,35,94,31
2158,숙박,헤이 서귀포,제주특별자치도 서귀포시 태평로 363,38,40,16,94,31
3762,음식점,한림웅담,제주특별자치도 제주시 한림읍 명랑남동길 42,38,33,22,93,31
2768,음식점,바캉스샤브샤브,제주특별자치도 제주시 조천읍 신북로 595,30,33,30,93,31
3313,음식점,유스커피,제주특별자치도 제주시 구산로 54,37,38,18,93,31
2984,음식점,소곱에,제주특별자치도 제주시 구좌읍 월정3길 53-9,30,35,29,94,31
2307,음식점,그리다앤쿡,제주특별자치도 제주시 신성로 111,32,35,27,94,31
2403,음식점,다미진,제주특별자치도 서귀포시 표선면 민속해안로 578-1,27,33,32,92,31
1163,쇼핑,삼다닷컴,제주시 연삼로 295-1,27,36,30,93,31
3772,음식점,할매추어탕,제주특별자치도 제주시 구남로 57 (이도이동),35,29,28,92,31
1413,숙박,돌꽃펜션,제주특별자치도 제주시 서해안로 572-1,39,33,21,93,31
3735,음식점,하늘채가든,제주특별자치도 제주시 오등14길 4,40,28,26,94,31
2234,음식점,갤러리 라운지,제주특별자치도 제주시 노연로 12,27,37,30,94,31
2797,음식점,별오름 노형점,제주특별자치도 제주시 1100로 3213-27,45,20,27,92,31
2566,음식점,루스트플레이스 삼화점,제주특별자치도 제주시 화삼로 21,29,39,25,93,31
1869,숙박,전원민박,제주특별자치도 제주시 우도면 우목길 104,26,37,30,93,31
3703,음식점,팝업 플라자,제주특별자치도 제주시 노연로 12,37,37,18,92,31
3091,음식점,아라파파 북촌점,제주특별자치도 제주시 조천읍 북촌15길 60,50,30,13,93,31
2964,음식점,성산일출봉 해송,제주특별자치도 서귀포시 성산읍 일출로 270-2,39,29,24,92,31
1942,숙박,제주잔잔,제주특별자치도 서귀포시 칠십리로485번길 15-17,27,40,27,94,31
2690,음식점,못잊어 감자탕,제주특별자치도 제주시 서광로32길 35,44,33,16,93,31
1864,숙박,잇츠힐,제주특별자치도 제주시 애월읍 애월해안로 788,25,33,35,93,31
1514,숙박,목조 독채민박 멍3닷컴,제주특별자치도 제주시 조천읍 와선로 236-14,28,30,35,93,31
3552,음식점,추자도중앙식당,제주특별자치도 제주시 추자면 추자로 8-1,37,23,33,93,31
3115,음식점,앙끄레국수,제주특별자치도 서귀포시 법환상로2번길 97-18,44,26,24,94,31
1523,숙박,물메랑,제주특별자치도 제주시 애월읍 수산북길 3,31,38,24,93,31
1610,숙박,블룸호텔,제주특별자치도 서귀포시 중문관광로72번길 53,33,33,26,92,31
1557,숙박,바산올레펜션,제주특별자치도 서귀포시 안덕면 대평로 29,38,31,23,92,31
1351,숙박,노을과원담,제주특별자치도 제주시 한경면 한경해안로 282,35,27,31,93,31
2445,음식점,더건강한빵,제주특별자치도 서귀포시 천제연로 185,29,35,28,92,31
1588,숙박,봉골레 하우스 민박,제주특별자치도 제주시 추자면 추자로 94-1 2층,27,30,35,92,31
2122,숙박,한모살,제주특별자치도 제주시 구좌읍 행원로1길 26,30,42,20,92,31
3652,음식점,클로리스 제주성산점,제주특별자치도 서귀포시 성산읍 성산등용로17번길 55,38,29,25,92,31
2149,숙박,해피데이 민박,제주특별자치도 제주시 한림읍 한림로 423,35,31,26,92,31
1364,숙박,늘해랑펜션,제주특별자치도 서귀포시 분토왓로174번길 34-1,29,37,28,94,31
3189,음식점,옛고을갈비,제주특별자치도 제주시 한림읍 한림상로 137,33,36,24,93,31
3104,음식점,아톰스낵,제주특별자치도 제주시 구좌읍 구좌로 91,37,28,29,94,31
2283,음식점,구닮카페(구름을닮다),제주특별자치도 서귀포시 안덕면 산방로 210,32,32,29,93,31
2216,음식점,가리본가 본점,제주특별자치도 제주시 성신로1길 17,28,38,27,93,31
2120,숙박,한라앤탐 펜션,제주특별자치도 서귀포시 남원읍 위미중앙로300번길 8,39,26,28,93,31
3053,음식점,승범이네집,제주특별자치도 제주시 월랑로 56-1 (노형동),23,38,32,93,31
1396,숙박,더블루제주,제주특별자치도 서귀포시 칠십리로 479,28,34,31,93,31
1602,숙박,블랙롯지,제주특별자치도 서귀포시 성산읍 서성일로991번길 25,32,38,20,90,30
1318,숙박,꽃향기바다소리,제주특별자치도 제주시 한경면 판조로 29,31,31,29,91,30
1677,숙박,수필하우스,제주특별자치도 제주시 구좌읍 종달논길 50-1,34,30,25,89,30
2822,음식점,봉you,제주 서귀포시 안덕면 중산간서로 1817,29,30,32,91,30
3566,음식점,칠사돈,제주 제주시 애월읍 하광로 17,27,35,29,91,30
1821,숙박,올레요리조트,제주특별자치도 서귀포시 이어도로 720,25,34,30,89,30
3664,음식점,탐라면,제주특별자치도 제주시 애월읍 애월로 37,37,32,21,90,30
1433,숙박,등대민박,제주특별자치도 제주시 추자면 대서2길 35,29,31,29,89,30
3114,음식점,알마니,제주특별자치도 제주시 구좌읍 해녀박물관길 37,18,44,27,89,30
300,관광지,"미악산 (?오름, 쌀오름, 솔오름)",제주특별자치도 서귀포시 인정오름로 387-63,89,0,0,89,30
3635,음식점,컬쳐드,제주특별자치도 제주시 승천로 81,30,38,22,90,30
1178,쇼핑,승희상회,제주특별자치도 제주시 구좌읍 종달로5길 32-1,22,30,38,90,30
1660,숙박,소라담하우스,제주특별자치도 제주시 조천읍 신촌남8길 10,27,32,31,90,30
1858,숙박,이어도펜션,제주특별자치도 제주시 도두항서5길 3,43,29,18,90,30
2939,음식점,서울분식,제주특별자치도 제주시 동문로4길 11,34,26,30,90,30
3370,음식점,재게재게옵서 카페,제주특별자치도 제주시 한림읍 비양도길 32-3,30,27,34,91,30
1590,숙박,봉쟈 게스트하우스,제주특별자치도 제주시 진동로 81,31,35,23,89,30
1380,숙박,달빛바다,제주특별자치도 제주시 어영길 64-12,37,32,21,90,30
1785,숙박,엘쯔타운펜션,제주특별자치도 제주시 애월읍 유수암평화길 136,32,36,22,90,30
3320,음식점,은희네해장국 외도점,제주특별자치도 제주시 우정로15길 42-8,43,30,17,90,30
3064,음식점,신동성식당,제주특별자치도 서귀포시 토평남로 109,26,38,25,89,30
2844,음식점,뷰스트,제주특별자치도 서귀포시 안덕면 형제해안로 30,43,25,21,89,30
2793,음식점,벨로인카페,제주특별자치도 제주시 서해안로 150 (도두일동),33,30,27,90,30
2036,숙박,테마하우스,제주특별자치도 제주시 백포북길 24,29,37,24,90,30
1593,숙박,북마크하우스&카페,제주특별자치도 서귀포시 대정읍 일과대수로11번길 16-8,26,49,15,90,30
1444,숙박,뜨리바다펜션,제주특별자치도 서귀포시 남원읍 태위로510번길 31-16,39,27,24,90,30
1794,숙박,여행스케치,제주특별자치도 서귀포시 일주서로 694,35,30,26,91,30
2210,음식점,ROAD129(로드129),제주특별자치도 제주시 애월읍 애월로 129,34,32,25,91,30
2050,숙박,파인힐호텔,제주특별자치도 서귀포시 부두로 44,36,31,22,89,30
1388,숙박,대물민박,제주특별자치도 제주시 추자면 추자로 507,18,44,27,89,30
2716,음식점,미미국수,제주특별자치도 제주시 삼성로 39,42,23,26,91,30
3318,음식점,으뜨미,제주특별자치도 제주시 구좌읍 중산간동로 2287,53,24,13,90,30
3383,음식점,제니의 정원,제주특별자치도 제주시 연삼로 17,22,34,34,90,30
2487,음식점,돈향기,제주특별자치도 제주시 관덕로15길 30,28,33,28,89,30
3743,음식점,하얀산호식당,제주특별자치도 제주시 우도면 우도해안길 136,34,26,30,90,30
2154,숙박,허브펜션 오즈,제주특별자치도 서귀포시 표선면 표선백사로58번길 36,28,35,27,90,30
2470,음식점,도리화과,제주특별자치도 제주시 아연로 194,27,36,28,91,30
1462,숙박,랑주호텔,제주특별자치도 서귀포시 김정문화로27번길 23-3,25,33,32,90,30
2073,숙박,포비네오두막게스트하우스,제주특별자치도 제주시 구좌읍 행원로4길 26,30,35,26,91,30
3284,음식점,웅담식당,제주특별자치도 서귀포시 중앙로59번길 5,28,23,38,89,30
2660,음식점,명문사거리식당,제주특별자치도 서귀포시 표선면 중산간동로 5218,41,23,26,90,30
1545,숙박,바다추억,제주특별자치도 제주시 용해로 27,33,31,26,90,30
2400,음식점,다래향 세화점,제주특별자치도 제주시 구좌읍 세화1길 4,33,29,29,91,30
2174,숙박,호텔서귀피안,제주특별자치도 서귀포시 보목로64번길 178 호텔서귀피안,33,30,28,91,30
2868,음식점,빌라드아토,제주특별자치도 서귀포시 태평로 413,33,33,25,91,30
1156,쇼핑,보미다,"제주특별자치도 서귀포시 이어도로 936-1, 2층 201호",25,36,29,90,30
1735,숙박,아마빌레,제주특별자치도 제주시 애월읍 애월해안로 909,29,33,28,90,30
3062,음식점,식과함께,제주특별자치도 서귀포시 안덕면 화순로142번길 11-9,35,30,24,89,30
2754,음식점,바람개비,제주특별자치도 제주시 우도면 우도해안길 1032,28,43,19,90,30
2535,음식점,띠띠빵빵,제주특별자치도 제주시 우도면 우도해안길 982,36,28,27,91,30
1543,숙박,바다위올레펜션,제주특별자치도 서귀포시 이어도로 826-13,37,34,19,90,30
3161,음식점,에릭스에스프레소 카페,제주시 구좌읍 세화7길 17-7,29,35,27,91,30
3837,음식점,황금손가락 노형점,제주특별자치도 제주시 1100로 2961,46,29,16,91,30
2377,음식점,노을코지,제주특별자치도 제주시 서해안로 386,37,34,18,89,30
2005,숙박,캠퍼트리호텔앤리조트,제주특별자치도 제주시 해안마을서4길 100,30,37,24,91,30
2529,음식점,또또시,제주특별자치도 서귀포시 쇠소깍로 151-8,35,32,24,91,30
2397,음식점,다담은,제주특별자치도 제주시 우정로15길 5,36,33,22,91,30
2242,음식점,겐짱야,제주특별자치도 제주시 월광로 140,22,34,33,89,30
1846,숙박,유앤아이게스트하우스,제주특별자치도 제주시 광양8길 1-2,32,37,22,91,30
3789,음식점,해변가든(켄싱턴리조트),제주특별자치도 서귀포시 이어도로 684,33,25,33,91,30
3294,음식점,월정리LOWA,제주특별자치도 제주시 구좌읍 해맞이해안로 472,29,24,38,91,30
2590,음식점,마돈,제주특별자치도 서귀포시 성산읍 섭지코지로 56,28,36,27,91,30
1269,숙박,강남하우스펜션,제주특별자치도 서귀포시 대정읍 형제해안로 316,33,36,22,91,30
2166,숙박,호텔 스카이파크 제주1호점,제주특별자치도 제주시 삼무로 48,33,36,21,90,30
3507,음식점,쫑이네해산물,제주특별자치도 서귀포시 성산읍 환해장성로 549,29,38,22,89,30
1249,숙박,JAY&CHLOE,제주도 서귀포시 대정읍 무릉중앙로 203,31,35,22,88,29
1363,숙박,늘푸른 게스트하우스,제주특별자치도 서귀포시 대정읍 하모백사로 29,17,48,21,86,29
2865,음식점,비테비테,제주특별자치도 서귀포시 중앙로54번길 38,38,26,23,87,29
1994,숙박,초콜릿펜션,제주특별자치도 제주시 도리로 106-17,41,25,22,88,29
1424,숙박,동원리조트제주,제주특별자치도 서귀포시 솔동산로10번길 45,20,47,20,87,29
3562,음식점,칠돈가 별관,제주특별자치도 제주시 남성로 43,49,24,13,86,29
3068,음식점,신성할망식당,제주특별자치도 제주시 신대로7길 23,32,24,32,88,29
2548,음식점,레드썬셋,제주특별자치도 제주시 구좌읍 구좌해안로 16,26,35,27,88,29
1580,숙박,별마로펜션,제주특별자치도 제주시 항골남길 32-16,30,33,24,87,29
1441,숙박,또올레펜션&게스트하우스,제주특별자치도 제주시 한경면 판포2길 44,27,38,21,86,29
1517,숙박,몬떼뷰 스테이,제주특별자치도 서귀포시 안덕면 사계남로 75-9,25,33,28,86,29
3382,음식점,제니스브레드,제주특별자치도 서귀포시 태평로 359,31,37,20,88,29
3806,음식점,허브올레,제주특별자치도 서귀포시 표선면 번영로 2543-5,28,31,28,87,29
1357,숙박,뉴아일랜드민박,제주특별자치도 제주시 추자면 추자로 581-6,22,35,30,87,29
3358,음식점,일품순두부함덕점,제주특별자치도 제주시 삼봉로2길 54,38,36,14,88,29
1350,숙박,노을과어울림,제주도 서귀포시 대정읍 노을해안로 638,23,33,30,86,29
2290,음식점,국수와냉면,제주특별자치도 제주시 탑동로 31-1,22,31,35,88,29
3378,음식점,정봉자커피 봉개점,제주특별자치도 제주시 번영로 514,30,37,21,88,29
3376,음식점,절물자연휴양림휴게소,제주특별자치도 제주시 명림로 584,44,23,19,86,29
1982,숙박,지현민박,제주특별자치도 제주시 우도면 우도해안길 794,30,24,32,86,29
1968,숙박,조이랜드펜션,제주특별자치도 제주시 애월읍 애원로 116-5,25,35,28,88,29
2851,음식점,블루밍제이,제주특별자치도 제주시 한림읍 명월로2길 6,32,31,25,88,29
1349,숙박,노을과 포도향기,제주특별자치도 제주시 애월읍 신상로 238-2,33,31,22,86,29
2312,음식점,그옛맛,제주특별자치도 제주시 서사로24길 12,30,23,33,86,29
2555,음식점,로드3.7 (road3.7),제주특별자치도 서귀포시 남원읍 태위로510번길 91-2,24,38,24,86,29
2325,음식점,김명자굴국밥 화북점,제주특별자치도 제주시 동화로 32,29,34,24,87,29
2328,음식점,김밥명가 서귀포점,제주특별자치도 서귀포시 서문로 5-2,44,28,14,86,29
1612,숙박,비스타리조트,제주특별자치도 제주시 서해안로 74,28,36,22,86,29
1600,숙박,블란디야,제주특별자치도 서귀포시 법환로 15,28,41,19,88,29
1490,숙박,리치웨이 펜션,제주특별자치도 서귀포시 남원읍 위미중앙로196번길 6-12,33,31,24,88,29
1499,숙박,마리아주펜션,서귀포시 성산읍 풍천로 142,20,38,29,87,29
1756,숙박,안녕프로젝트 게스트하우스,제주특별자치도 제주시 구좌읍 동복로2길 12,35,36,16,87,29
3796,음식점,해적선,제주특별자치도 제주시 추자면 추자로 42-1,28,17,42,87,29
2618,음식점,만선바다,제주특별자치도 제주시 삼무로1길 6,39,32,16,87,29
2152,숙박,핸즈인제주,제주시 구좌읍 비자숲길 13,26,30,31,87,29
2197,음식점,24시 뼈다귀탕 제주점,제주특별자치도 제주시 동광로 19-1,34,27,27,88,29
3520,음식점,창훈이네,제주특별자치도 서귀포시 칠십리로 77,29,25,33,87,29
2176,숙박,호텔엘린,제주특별자치도 제주시 은남1길 4,32,29,26,87,29
2015,숙박,코자호텔,제주특별자치도 서귀포시 대정읍 최남단해안로 44,29,35,23,87,29
3267,음식점,우리동네숯불갈비,제주특별자치도 제주시 추자면 추자로 10-2,32,30,26,88,29
2343,음식점,꽃밭에서,제주특별자치도 제주시 516로 3157 라동 101호 (아라일동),28,28,31,87,29
3326,음식점,이돈갓시청점,제주특별자치도 제주시 광양14길 9,22,34,30,86,29
2019,숙박,콤마게스트하우스,제주특별자치도 서귀포시 표선면 표선중앙로 73-9,29,39,18,86,29
2371,음식점,네이쳐캔바스,제주특별자치도 서귀포시 남원읍 중산간동로 7129,37,24,27,88,29
2364,음식점,내담,제주특별자치도 서귀포시 예래로 296-1,35,34,17,86,29
3308,음식점,유나카페,서귀포시 남원읍 공천포로 81,27,34,27,88,29
3621,음식점,카페희상,제주특별자치도 서귀포시 표선면 표선동서로 324-18,23,31,32,86,29
2381,음식점,놀놀카페,제주특별자치도 제주시 구좌읍 비자림로 2228,25,30,33,88,29
1204,쇼핑,자연이야기,제주특별자치도 제주시 월랑로 6 21 (노형동),22,38,26,86,29
1475,숙박,로베로호텔,제주특별자치도 제주시 관덕로 26,36,35,17,88,29
3680,음식점,텐피자,제주특별자치도 서귀포시 대정읍 형제해안로 268,27,37,24,88,29
2404,음식점,다미회,제주특별자치도 제주시 동광로2길 9-4,27,31,28,86,29
1658,숙박,소낭재,제주특별자치도 제주시 한림읍 협재로 181-57,24,32,30,86,29
3283,음식점,웃뜨르우리돼지,제주특별자치도 제주시 한경면 연명로 2,30,32,24,86,29
2389,음식점,늘예솔,제주특별자치도 서귀포시 성산읍 일주동로 5335,30,30,27,87,29
2842,음식점,불만나,제주특별자치도 제주시 애월읍 하귀5길 14,29,35,24,88,29
1744,숙박,아이콘민박,제주특별자치도 제주시 추자면 신양서길 42-17,29,30,29,88,29
1909,숙박,제주별바람,제주특별자치도 제주시 한림읍 한림해안로 500,24,29,30,83,28
3764,음식점,한마음돈가돈,제주특별자치도 제주시 연신로 91,38,24,22,84,28
3110,음식점,안전식당,제주특별자치도 제주시 사라봉길 4,34,32,17,83,28
1331,숙박,나무이야기게스트하우스 2호점,제주특별자치도 서귀포시 남원읍 남한로21번길 9,27,32,25,84,28
1474,숙박,로뎀펜션,제주특별자치도 제주시 우도면 우도해안길 264,27,35,21,83,28
3273,음식점,우뭇개일번지,제주특별자치도 서귀포시 성산읍 일출로 288,31,34,18,83,28
2763,음식점,바삭돈까스 신서귀포점,제주특별자치도 서귀포시 김정문화로 5,38,22,23,83,28
3739,음식점,하르비커피,제주특별자치도 서귀포시 칠십리로 115,28,24,31,83,28
1775,숙박,에스호텔,제주특별자치도 제주시 오일장중길 26,32,31,22,85,28
1897,숙박,제주로얄호텔,제주특별자치도 제주시 신대로12길 45,29,37,18,84,28
1730,숙박,아띠랑스호텔,제주특별자치도 서귀포시 성산읍 해맞이해안로 2614,24,25,34,83,28
1578,숙박,벼리게스트하우스,제주특별자치도 제주시 구좌읍 면수1길 27,30,30,25,85,28
3201,음식점,오또도넛,제주특별자치도 서귀포시 중문상로 87,31,28,26,85,28
2759,음식점,바로족발보쌈 별관,제주특별자치도 제주시 진군중길 3,33,27,25,85,28
1457,숙박,라자관광호텔,제주특별자치도 제주시 연동6길 33,35,33,16,84,28
1776,숙박,에이지하우스,제주특별자치도 서귀포시 표선면 돈오름로23번길 36-46,27,30,26,83,28
3778,음식점,함덕카페h,제주특별자치도 제주시 조천읍 함대로3길 24-9,23,37,25,85,28
2024,숙박,클로버비앤비,제주특별자치도 서귀포시 성산읍 시흥상동로 109,20,37,26,83,28
3043,음식점,스시도모다찌 칠성점,제주특별자치도 제주시 관덕로13길 3,39,22,23,84,28
2778,음식점,백번가든,제주특별자치도 제주시 애월읍 애월로 120,34,30,21,85,28
1452,숙박,라벤다호텔,제주특별자치도 서귀포시 중정로 1,23,36,25,84,28
3426,음식점,제주시 새우리,제주특별자치도 제주시 무근성7길 21 (삼도2동),33,27,23,83,28
1758,숙박,알랑가게스트하우스,제주특별자치도 서귀포시 안덕면 사계남로153번길 2,23,33,27,83,28
1362,숙박,늘송파크텔,제주특별자치도 제주시 원노형5길 22,31,34,20,85,28
2761,음식점,바보라면,제주특별자치도 제주시 구좌읍 해맞이해안로 1016,26,40,18,84,28
2090,숙박,피노호텔,제주특별자치도 서귀포시 천지연로29번길 5,20,38,26,84,28
2089,숙박,플로라펜션,제주특별자치도 제주시 도리로 78-2,29,34,22,85,28
2728,음식점,미풍해장국 서귀포직영점,제주특별자치도 서귀포시 신동로27번길 12-4,46,22,16,84,28
3351,음식점,일출왕뚝배기,제주특별자치도 서귀포시 성산읍 일출로 247,37,20,27,84,28
1716,숙박,썬비치민박,제주특별자치도 제주시 우도면 우도해안길 810,23,21,40,84,28
2825,음식점,봉끄랑횟집,제주시 한림읍 한림로 121-3,28,24,31,83,28
3463,음식점,조은빵,제주특별자치도 제주시 인다3길 9,30,34,19,83,28
3624,음식점,커피가게&쉬고가게,제주특별자치도 서귀포시 표선면 민속해안로 593,26,33,26,85,28
1979,숙박,쥬빌리펜션,제주특별자치도 서귀포시 안덕면 소기왓로 84,26,34,24,84,28
3646,음식점,쿠싱 샌드위치,제주특별자치도 제주시 한경면 중산간서로 3728 (저지리),30,29,26,85,28
1224,쇼핑,캔북스,제주특별자치도 제주시 남광로4길 27,30,25,29,84,28
2438,음식점,대춘해장국,제주특별자치도 제주시 연북로 398,31,27,27,85,28
2583,음식점,리치망고우도점,제주특별자치도 제주시 우도면 우도해안길 1132,35,24,24,83,28
2449,음식점,더클리프,제주특별자치도 서귀포시 중문관광로 154-17,27,38,18,83,28
1151,쇼핑,바당의물질,제주특별자치도 제주시 임항로 49,25,31,27,83,28
2150,숙박,해피펜션,제주특별자치도 제주시 월대1길 4,31,31,23,85,28
3637,음식점,컴플리트커피,제주특별자치도 제주시 국기로4길 1,32,32,21,85,28
2267,음식점,곤밥2,제주특별자치도 제주시 서부두남길 8,32,24,27,83,28
2270,음식점,골목카페옥수,제주특별자치도 제주시 애월읍 소길1길 19,39,26,18,83,28
2407,음식점,다이노바이트 샌드위치,제주특별자치도 제주시 관덕로 16,29,34,22,85,28
2188,숙박,휴마루리조트,제주특별자치도 서귀포시 중산간동로8183번길 16,27,31,26,84,28
2454,음식점,덕승식당(신관),제주특별자치도 서귀포시 대정읍 최남단해안로30번길 4,41,28,15,84,28
2401,음식점,다래향2호점,제주특별자치도 제주시 구좌읍 세화1길 4,25,29,29,83,28
3256,음식점,우도몬딱,제주특별자치도 제주시 우도면 우도해안길 794,21,31,32,84,28
2686,음식점,몬떼마레,제주특별자치도 서귀포시 안덕면 사계북로 120 루시드엠빌딩,27,28,28,83,28
1371,숙박,다이브게스트하우스,제주도 서귀포시 월드컵로 222,28,30,25,83,28
3122,음식점,애나의숲 브런치카페,"제주특별자치도 서귀포시 중동로48번길 8 (서귀동, 귤섬가) 1층",83,0,0,83,28
3357,음식점,일품순두부탑동점,제주특별자치도 제주시 탑동로 33,31,32,20,83,28
1376,숙박,단추스테이,제주특별자치도 제주시 한림읍 금능1길 15-8,25,35,25,85,28
3261,음식점,우도짜장맨,제주특별자치도 제주시 우도면 우도해안길 1132,50,24,11,85,28
1536,숙박,민중각 게스트하우스,제주특별자치도 서귀포시 서문로28번길 4,28,25,30,83,28
2898,음식점,산호사 해녀의집,제주특별자치도 제주시 우도면 연평리 2565,27,28,28,83,28
3676,음식점,털보네 고양이,제주특별자치도 서귀포시 남원읍 태위로 381,25,34,26,85,28
3059,음식점,시영통닭,제주특별자치도 제주시 용문로 160,31,31,23,85,28
2383,음식점,누리해장국,제주특별자치도 제주시 번영로 485,32,34,18,84,28
2570,음식점,루스트플레이스 아이파크점,제주특별자치도 제주시 노형8길 9,25,34,26,85,28
2161,숙박,호스텔린든(Hostel lyndon),제주특별자치도 제주시 서광로 278,28,37,16,81,27
1549,숙박,바다향기,제주특별자치도 제주시 서흘길 24,28,24,30,82,27
2087,숙박,플라마 펜션,제주특별자치도 제주시 한림읍 장원길 34-29,25,40,15,80,27
3500,음식점,진부령 황태해장국,제주특별자치도 제주시 사장길 12,48,20,12,80,27
3057,음식점,시스베이글,제주특별자치도 서귀포시 남원읍 태위로 87,30,28,22,80,27
3195,음식점,오누이밥상,제주특별자치도 제주시 추자면 추자로 68,36,21,25,82,27
3207,음식점,오르막가든,제주특별자치도 서귀포시 대포중앙로 12,23,29,29,81,27
2810,음식점,보엠,제주특별자치도 제주시 원노형로 102,28,30,24,82,27
2804,음식점,보말고을,제주특별자치도 제주시 애월읍 광령중길 133-1,41,27,14,82,27
2171,숙박,호텔더원,제주특별자치도 제주시 사장3길 33,31,26,23,80,27
1342,숙박,낭만펜션,제주특별자치도 제주시 도두5길 28,24,36,21,81,27
3841,음식점,황제궁,제주특별자치도 제주시 조천읍 남조로 3090,31,31,19,81,27
1141,쇼핑,마야블루,제주특별자치도 제주시 월랑로6길 21,25,27,28,80,27
2098,숙박,하늘조각,제주특별자치도 서귀포시 안덕면 사계북로 75,27,32,21,80,27
3214,음식점,오일등식당,제주특별자치도 제주시 도공로 22-1,36,26,19,81,27
1136,쇼핑,디자인에이비,제주특별자치도 제주시 한경면 판포4길 22,29,30,22,81,27
3812,음식점,현기네식당,제주특별자치도 제주시 번영로 487,28,28,25,81,27
2132,숙박,해마관광호텔,제주특별자치도 제주시 삼무로 28,35,35,11,81,27
1138,쇼핑,라바북스,제주특별자치도 서귀포시 남원읍 태위로 87 1층,27,30,23,80,27
2933,음식점,서민흑돼지,제주특별자치도 서귀포시 예래로 50,24,25,33,82,27
2141,숙박,해성펜션,제주특별자치도 서귀포시 천제연로 131-8,36,26,19,81,27
2365,음식점,내창생태카페,제주특별자치도 서귀포시 남원읍 하례로 393,32,33,16,81,27
1493,숙박,마니주팬션,제주특별자치도 제주시 서해안로 248,27,37,18,82,27
3231,음식점,올레삼다정,제주특별자치도 서귀포시 태평로537번길 48,30,27,25,82,27
2830,음식점,봉평메밀가,제주시 신대로 10길 41,29,30,22,81,27
3636,음식점,컬쳐드 아라점,제주특별자치도 제주시 승천로 81,27,34,19,80,27
1650,숙박,성게돌 펜션,제주특별자치도 서귀포시 쇠소깍로 186,16,32,32,80,27
2604,음식점,마므레,제주특별자치도 서귀포시 남원읍 태위로 456,27,31,24,82,27
1125,쇼핑,다시방프로젝트,제주특별자치도 제주시 조천읍 북촌12길 28,27,35,19,81,27
3089,음식점,아뜰리에안,제주특별자치도 서귀포시 막숙포로 166,24,31,25,80,27
2021,숙박,콴도제주,제주특별자치도 서귀포시 남원읍 태위로151번길 14-12,26,34,20,80,27
1191,쇼핑,얼리스프링플라워,제주특별자치도 제주시 구남동2길 45-12,23,32,27,82,27
2461,음식점,델문도로스터스,제주특별자치도 제주시 연삼로 316,26,37,18,81,27
2990,음식점,소소당양갱,제주특별자치도 서귀포시 안덕면 신화역사로685번길 236,37,27,18,82,27
1697,숙박,스프링데일골프앤리조트,제주특별자치도 서귀포시 남원읍 서성로 459,40,20,21,81,27
2408,음식점,다정이네,제주특별자치도 서귀포시 동문로 59-1,37,21,24,82,27
1930,숙박,제주엔펜션,제주특별자치도 서귀포시 대정읍 노을해안로 614,37,29,14,80,27
3156,음식점,어피니티,제주특별자치도 제주시 남성로 78,24,29,27,80,27
1873,숙박,제이드림호텔(jdream hotel),제주특별자치도 제주시 은남1길 40,21,40,20,81,27
3829,음식점,홍요깃거리카페,제주특별자치도 제주시 애월읍 애월해안로 352,30,24,28,82,27
1890,숙박,제주도통나무펜션,제주특별자치도 서귀포시 남원읍 태위로 551-5,26,32,23,81,27
2911,음식점,삼수정,제주특별자치도 서귀포시 성산읍 동류암로 45,30,26,24,80,27
3323,음식점,이가전복,제주특별자치도 제주시 무근성길 6,24,29,29,82,27
3324,음식점,이게밥도둑,제주특별자치도 제주시 삼무로7길 23,35,22,25,82,27
2744,음식점,바다어사또,제주특별자치도 제주시 조천읍 조함해안로 478,26,35,19,80,27
1980,숙박,지니코티지,제주특별자치도 제주시 한경면 수동1길 15,30,32,20,82,27
1807,숙박,오빌하우스,제주특별자치도 서귀포시 남원읍 공천포로11번길 15,24,26,30,80,27
2298,음식점,귤하르방 동문시장점,제주특별자치도 제주시 동문로4길 18,44,24,14,82,27
3150,음식점,어애랑,제주특별자치도 제주시 한림읍 한림로 422 (협재리) 어애랑,28,25,28,81,27
2018,숙박,코쿤호텔,제주특별자치도 제주시 애월읍 중엄3길 50,23,32,27,82,27
1348,숙박,노블렛휴양펜션,제주특별자치도 서귀포시 남원읍 남조로 861-83,25,29,26,80,27
1865,숙박,자넷앤캐시,제주시 구좌읍 평대9길 20-1,28,32,22,82,27
1470,숙박,레프트핸더 게스트하우스,제주특별자치도 제주시 구좌읍 상도북2길 17-12,24,42,16,82,27
2862,음식점,비원,제주특별자치도 제주시 수목원길 3,28,25,27,80,27
2299,음식점,그계절,제주특별자치도 제주시 구좌읍 한동로 119,21,33,27,81,27
2527,음식점,땡큐베리,제주특별자치도 서귀포시 칠십리로 97,28,31,23,82,27
3287,음식점,원더먼트제주,제주특별자치도 제주시 조천읍 신북로 163,26,33,21,80,27
1823,숙박,올레해오름펜션,제주특별자치도 제주시 애월읍 광령평화2길 142-19,30,26,25,81,27
1817,숙박,오후여섯시펜션,제주특별자치도 제주시 애월읍 곽지9길 10,31,27,22,80,27
1336,숙박,나바론민박,제주특별자치도 제주시 추자면 추자로 76-1,15,41,21,77,26
1189,쇼핑,야호농수산,제주특별자치도 제주시 용해로 112,18,27,34,79,26
3316,음식점,육값하네식육가든,제주특별자치도 서귀포시 남원읍 남조로 141,32,22,23,77,26
3453,음식점,제주틈,제주특별자치도 제주시 한림읍 일주서로 5153,23,33,23,79,26
2060,숙박,퍼시픽호텔,제주특별자치도 제주시 서사로 20,25,35,19,79,26
3518,음식점,참이쁜돼지,제주특별자치도 서귀포시 천제연로232번길 16,28,31,20,79,26
3517,음식점,참솔식당,제주특별자치도 제주시 애월읍 유수암평화5길 21,40,23,16,79,26
1506,숙박,메이더호텔,제주특별자치도 제주시 구좌읍 일주동로 1626,27,28,24,79,26
3440,음식점,제주웅담,제주특별자치도 제주시 한림읍 한림로5길 23,23,19,36,78,26
2440,음식점,대춘해장국 시청점,제주특별자치도 제주시 동광로2길 9-1,22,27,29,78,26
3625,음식점,커피가게쉬고가게,제주특별자치도 서귀포시 표선면 민속해안로 593,22,30,26,78,26
2977,음식점,세가름,제주특별자치도 제주시 한경면 신한로 20,31,28,19,78,26
3029,음식점,순희뽀글이정식,제주특별자치도 제주시 공설로 27-1,30,21,27,78,26
1884,숙박,제주공항 고추잠자리 게스트하우스,제주특별자치도 제주시 도령로 190,27,33,18,78,26
2068,숙박,펠리스타운,제주특별자치도 서귀포시 성산읍 시흥하동로50번길 23,28,30,20,78,26
2715,음식점,미루네,제주특별자치도 제주시 오복4길 5 (이도이동),23,41,14,78,26
2295,음식점,귀덕간식,제주특별자치도 제주시 한림읍 귀덕로 8-1 (귀덕리),33,22,24,79,26
2719,음식점,미소짓는 흑도야지,제주특별자치도 제주시 국기로3길 9,30,25,23,78,26
2832,음식점,뵈뵈,제주특별자치도 제주시 구좌읍 계룡길 73,26,24,29,79,26
2722,음식점,미엘드세화,제주특별자치도 제주시 구좌읍 해맞이해안로 1464,27,31,21,79,26
2167,숙박,호텔 앨리스앤트렁크,제주특별자치도 제주시 연동12길 4,18,29,31,78,26
2076,숙박,포지타노인제주,제주특별자치도 서귀포시 성산읍 신천서로 27-5,26,28,24,78,26
1461,숙박,란펜션,제주특별자치도 제주시 용마서1길 19-2,18,39,22,79,26
2476,음식점,돈돼지흑돼지,제주특별자치도 서귀포시 표선면 표선백사로 108,31,24,22,77,26
1477,숙박,로지게스트하우스,제주특별자치도 제주시 조천읍 신흥관전길 58,27,28,22,77,26
2736,음식점,바닐라파레트,제주특별자치도 제주시 진군길 56-2,22,30,27,79,26
3576,음식점,카페 소바니,제주특별자치도 제주시 애월읍 곽지3길 18,29,32,16,77,26
2011,숙박,켄싱턴리조트 제주중문,제주특별자치도 서귀포시 중문관광로72번길 29-29,23,25,29,77,26
2348,음식점,나눔김밥,제주특별자치도 제주시 성신로 26,32,23,23,78,26
2694,음식점,묘한상점 묘한카페,제주특별자치도 서귀포시 성산읍 시흥상동로 87,22,29,27,78,26
2505,음식점,동백별장,제주특별자치도 제주시 원노형3길 44,44,21,13,78,26
2559,음식점,로스트&헤븐,제주특별자치도 제주시 테우해안로 162,22,21,34,77,26
2462,음식점,도가촌,제주특별자치도 서귀포시 동홍동로 39,28,29,22,79,26
1700,숙박,시땅,제주특별자치도 제주시 애월읍 고내북동길 47,24,30,23,77,26
1540,숙박,바다산책,제주특별자치도 서귀포시 남원읍 남태해안로 11-15,26,31,21,78,26
2153,숙박,허브인휴양펜션,제주특별자치도 제주시 한림읍 귀덕6길 92-17,25,30,23,78,26
1539,숙박,바다드림,제주특별자치도 제주시 어영길 18-9,29,31,17,77,26
1466,숙박,레몬이네 민박,제주특별자치도 제주시 추자면 대서6길 46,21,33,24,78,26
1810,숙박,오션스카이,제주특별자치도 제주시 구좌읍 덕행로 450-15,19,26,33,78,26
1789,숙박,엠버호텔 센트럴,제주특별자치도 제주시 노연로 24,28,36,15,79,26
3826,음식점,홍도니,제주특별자치도 제주시 연북로 187,31,28,20,79,26
2957,음식점,섯동네해녀의집,제주특별자치도 제주시 우도면 연평리 2515-5,23,23,32,78,26
1319,숙박,꿀잠자리,제주특별자치도 서귀포시 대정읍 최남단해안로30번길 14,29,31,18,78,26
2997,음식점,솔향,제주특별자치도 제주시 애월읍 일주서로 6113,26,32,21,79,26
3307,음식점,유끼네,제주특별자치도 서귀포시 표선면 성읍정의현로136번길 5-8,25,28,24,77,26
3337,음식점,이찌마루,제주특별자치도 제주시 구좌읍 월정1길 54-11,28,28,22,78,26
1284,숙박,고불락하우스,제주특별자치도 제주시 애월읍 고내로7길 45-12,24,38,16,78,26
2670,음식점,모닥치기,제주특별자치도 제주시 남광로2길 17,48,16,13,77,26
2361,음식점,낭만주의,제주특별자치도 제주시 내도1길 18-1,28,23,25,76,25
3462,음식점,조아찌,제주특별자치도 제주시 테우해안로 160,27,27,20,74,25
2025,숙박,킴스캐빈,제주특별자치도 서귀포시 성산읍 시흥상동로53번길 88-54,15,35,24,74,25
3085,음식점,씨리얼,제주특별자치도 제주시 한림읍 명랑로 26,27,33,16,76,25
3557,음식점,춘희,제주특별자치도 제주시 구좌읍 해녀박물관길 33-2,23,37,16,76,25
2047,숙박,파미유스파리조트,제주특별자치도 서귀포시 이어도로 826-6,26,29,19,74,25
2049,숙박,파인비치,제주특별자치도 서귀포시 남원읍 태위로 976-10,20,37,17,74,25
3717,음식점,풍림다방 송당점,제주특별자치도 제주시 구좌읍 중산간동로 2267-4,40,23,11,74,25
2059,숙박,패밀리아팬션,제주특별자치도 서귀포시 표선면 번영로 3340,19,38,18,75,25
2063,숙박,펜션 에덴호스텔,제주특별자치도 제주시 서해안로 456-12,43,17,14,74,25
3512,음식점,차이나 하우스,제주특별자치도 제주시 노연로 12,33,20,21,74,25
3328,음식점,이런날N,제주특별자치도 제주시 구좌읍 한동북1길 60 A동 2층,16,32,27,75,25
1146,쇼핑,몸냥공작소,제주특별자치도 제주시 애월읍 하소로 595,25,26,24,75,25
3838,음식점,황금어장,제주특별자치도 서귀포시 중앙로48번길 14,27,21,28,76,25
1959,숙박,제주필하우스,제주특별자치도 제주시 조천읍 일주동로 1415,29,25,20,74,25
1822,숙박,올레프로방스,제주특별자치도 제주시 애월읍 광령평화2길 170-23,27,33,16,76,25
1184,쇼핑,아워키친,제주특별자치도 제주시 노형4길 23,24,30,22,76,25
3120,음식점,앞돈지,제주특별자치도 제주시 중앙로1길 28(건입동),27,24,24,75,25
3584,음식점,카페덕수리2180,제주특별자치도 서귀포시 안덕면 덕수동로25번길 42-8,27,27,20,74,25
1422,숙박,동산나라펜션,제주특별자치도 서귀포시 이어도로 164,28,27,20,75,25
2941,음식점,서진향해장국,제주특별자치도 제주시 제주대학로 183,32,27,17,76,25
2326,음식점,김명자굴국밥(성산점),제주특별자치도 서귀포시 성산읍 성산중앙로 46-1,27,31,17,75,25
2953,음식점,섭지코지로,제주특별자치도 서귀포시 성산읍 시흥하동로57번길 35,27,28,20,75,25
2595,음식점,마라도횟집,제주특별자치도 제주시 신광로8길 3,28,26,20,74,25
1314,숙박,김선장네 민박,제주특별자치도 제주시 추자면 영흥1길 14,20,35,20,75,25
2247,음식점,경주네횟집,제주특별자치도 제주시 연동6길 28,16,28,31,75,25
2483,음식점,돈채,제주특별자치도 제주시 우도면 우도로 16,16,31,28,75,25
1765,숙박,약천골민박,제주특별자치도 서귀포시 이어도로 303,28,34,12,74,25
3631,음식점,커피주의보,제주시 남광로 16,23,32,21,76,25
3627,음식점,커피림,제주특별자치도 제주시 수목원길 27,21,28,27,76,25
1190,쇼핑,언제라도 북스&리틀갤러리,제주특별자치도 제주시 구좌읍 문주란로5길 34-2,22,29,24,75,25
2419,음식점,달에,제주특별자치도 제주시 애월읍 고내로9길 44-2,22,25,27,74,25
3785,음식점,해담은,제주특별자치도 제주시 남광북1길 41,25,30,21,76,25
1526,숙박,미라클게스트하우스,제주특별자치도 제주시 서해안로 346-9,21,28,27,76,25
3233,음식점,올레실내포장마차,제주특별자치도 제주시 추자면 추자로 52,37,19,19,75,25
2004,숙박,캐슬 드 한림,제주특별자치도 제주시 한림읍 강구로 95-7,21,25,28,74,25
2410,음식점,달그락식탁,제주특별자치도 제주시 조천읍 신흥로 2,29,24,22,75,25
2402,음식점,다미안,제주특별자치도 서귀포시 이어도로 905,39,16,20,75,25
1501,숙박,마빈,제주특별자치도 제주시 조천읍 일주동로 1532,30,33,13,76,25
2254,음식점,고로케야,제주특별자치도 제주시 가령골2길 13-20,26,32,17,75,25
3802,음식점,행복미가,제주특별자치도 제주시 구남동5길 12,31,28,17,76,25
3538,음식점,청춘부부,제주특별자치도 서귀포시 대정읍 추사로38번길 181,35,20,21,76,25
1365,숙박,다노이커플펜션,제주특별자치도 제주시 구좌읍 동복로 51,26,28,21,75,25
2250,음식점,고고리식당,제주특별자치도 제주시 인다5길 11-10,25,30,21,76,25
3834,음식점,황금무지개,제주특별자치도 서귀포시 표선면 표선관정로 113-2,23,33,20,76,25
2237,음식점,거기제주,제주특별자치도 서귀포시 대정읍 노을해안로 732 (신도리),22,25,27,74,25
2138,숙박,해변의집,제주특별자치도 제주시 서해안로 224-1,25,34,17,76,25
2444,음식점,더 콘테나,제주특별자치도 제주시 조천읍 함와로 513,32,28,16,76,25
3032,음식점,숨비나리카페,제주특별자치도 서귀포시 안덕면 중산간서로1615번길 8,27,27,17,71,24
3848,음식점,휴일로,제주특별자치도 서귀포시 안덕면 난드르로 49-65,35,20,18,73,24
2934,음식점,서바당횟집,제주특별자치도 서귀포시 대정읍 마라로 75,28,28,17,73,24
3264,음식점,우도향,제주특별자치도 제주시 우도면 우도해안길 848,26,25,22,73,24
1268,숙박,감비나무,제주특별자치도 제주시 구좌읍 일주동로 2970,25,23,23,71,24
2853,음식점,블루하우스,서귀포시 중앙로 73,27,26,19,72,24
2217,음식점,가비오타카페,제주특별자치도 제주시 구좌읍 해맞이해안로 2030 (종달리),23,23,25,71,24
3003,음식점,쇼디치카페,제주특별자치도 제주시 구좌읍 해맞이해안로 1440,23,23,25,71,24
3755,음식점,한라성,제주특별자치도 서귀포시 돈내코로 95,31,23,18,72,24
3548,음식점,촵촵,제주특별자치도 제주시 신설로9길 8-1,19,30,22,71,24
2263,음식점,고요새,제주특별자치도 제주시 선사로8길 11,42,18,13,73,24
1682,숙박,쉴띠펜션&게스트하우스,제주특별자치도 서귀포시 안덕면 한창로 104,23,28,21,72,24
2787,음식점,벙커하우스,제주특별자치도 서귀포시 막숙포로41번길 66,30,24,18,72,24
3443,음식점,제주인짬뽕,제주특별자치도 제주시 지석12길 14,29,21,21,71,24
3560,음식점,친구네 분식,제주특별자치도 서귀포시 대정읍 신영로 124-1,31,21,19,71,24
3634,음식점,커피파인더,제주특별자치도 제주시 서광로32길 20,23,25,25,73,24
1710,숙박,실크로드펜션,제주특별자치도 제주시 용해로 21-6,27,25,21,73,24
2137,숙박,해변여행,제주특별자치도 제주시 애월읍 가문동길 41-2,19,33,20,72,24
1915,숙박,제주산내들,제주특별자치도 서귀포시 표선면 풍천로273번길 143-4,23,24,26,73,24
3711,음식점,포스트커피,제주특별자치도 제주시 중앙로 319-1,31,27,15,73,24
1797,숙박,예다움휴양펜션,제주특별자치도 제주시 백포북길 25,23,34,16,73,24
2344,음식점,꽃자리,제주특별자치도 서귀포시 소암로 29,31,25,17,73,24
1538,숙박,밀물민박,제주특별자치도 제주시 추자면 추자로 106-1,31,20,21,72,24
1263,숙박,가원비치펜션,제주특별자치도 서귀포시 표선면 표선백사로 127,20,27,26,73,24
2042,숙박,투데이제주펜션,제주특별자치도 서귀포시 예래로 267-2,17,24,30,71,24
2504,음식점,동막골,제주특별자치도 제주시 구산로 43-1,22,33,16,71,24
1183,쇼핑,아름낭,제주특별자치도 서귀포시 중산간서로157번길 26,26,23,22,71,24
3222,음식점,온미(溫米),제주특별자치도 서귀포시 김정문화로41번길 24-5 1층,25,25,23,73,24
2374,음식점,노리터스낵,제주특별자치도 제주시 애월읍 고하상로 102,29,21,21,71,24
2372,음식점,노네임드봉개,제주특별자치도 제주시 봉개동길 29-1,30,23,19,72,24
3704,음식점,패밀리만두,제주특별자치도 제주시 국기로 9,31,26,14,71,24
2075,숙박,포유펜션,제주특별자치도 서귀포시 남원읍 서의로 40-6,31,20,22,73,24
2608,음식점,마중물삼계탕,제주특별자치도 제주시 서사로 62-3,26,21,25,72,24
1187,쇼핑,안나네꽃마을,제주특별자치도 제주시 한라대학로 79,20,34,18,72,24
3472,음식점,준반점,제주특별자치도 제주시 조천읍 조함해안로 528,18,31,23,72,24
2126,숙박,핫플게스트하우스,서귀포시 성산읍 한도로242번길 8,26,31,15,72,24
2349,음식점,나라돈까스,제주특별자치도 제주시 절물1길 23,42,18,12,72,24
2629,음식점,맛있는 여가생활,제주특별자치도 제주시 한림읍 귀덕로 60,25,27,21,73,24
3253,음식점,우도동식이,제주특별자치도 제주시 우도면 우도해안길 276,24,18,28,70,23
3223,음식점,온오프,제주특별자치도 제주시 우도면 우도해안길 876,34,21,13,68,23
1601,숙박,블랑게스트하우스,제주특별자치도 서귀포시 표선면 표선관정로43번길 76-31,23,27,20,70,23
1691,숙박,스쿠버스토리,제주특별자치도 서귀포시 태평로536번길 17,21,32,15,68,23
2339,음식점,꼬신김밥 본점,제주특별자치도 제주시 화삼로 7,29,28,13,70,23
1824,숙박,올리수펜션,제주특별자치도 서귀포시 중문로5번길 16,18,30,20,68,23
1706,숙박,신산게스트하우스,제주특별자치도 서귀포시 성산읍 환해장성로121번길 21,22,26,21,69,23
2363,음식점,내가 찾은 맛고을,제주특별자치도 제주시 진남로8길 39,33,24,12,69,23
3568,음식점,카카듀,제주특별자치도 제주시 박성내서길 18,23,23,23,69,23
3330,음식점,이성필 커피볶는집,제주특별자치도 제주시 이도2동 광양8길 1,23,21,25,69,23
1860,숙박,인더 하우스,제주특별자치도 제주시 애월읍 엄장로 98-41,27,28,15,70,23
3020,음식점,순두부엔짬뽕,제주특별자치도 제주시 통물길 30,34,19,16,69,23
1238,쇼핑,한복담,제주특별자치도 제주시 신대로12길 51,18,38,12,68,23
1603,숙박,블랙샌즈호텔,제주특별자치도 제주시 선사로 8,23,27,20,70,23
1222,쇼핑,천진낭만,제주특별자치도 제주시 우도면 우도해안길 108,26,24,20,70,23
2066,숙박,펜션해다미,제주특별자치도 제주시 서해안로 502,27,22,20,69,23
3645,음식점,콜로세움,제주특별자치도 제주시 민오름길 14,24,25,20,69,23
3471,음식점,죽성고을,제주특별자치도 제주시 한북로 176,28,28,13,69,23
2099,숙박,하늘타리펜션,제주특별자치도 제주시 연대마을길 59,25,32,13,70,23
2134,숙박,해바라기,제주도 제주시 한림읍 협재로 33,25,30,15,70,23
2199,음식점,24시누름돌김치찌개,제주특별자치도 제주시 노연로 146,45,16,8,69,23
2148,숙박,해피데이,제주특별자치도 제주시 한림읍 한림로 423,26,21,21,68,23
3418,음식점,제주분식,제주특별자치도 제주시 귀아랑길 23,23,28,19,70,23
2420,음식점,달인수산,제주특별자치도 서귀포시 중정로73번길 22,41,19,9,69,23
1801,숙박,옛살라비,제주특별자치도 제주시 애월읍 광령8길 47,28,23,18,69,23
2818,음식점,본디국수,제주특별자치도 제주시 중앙로 276,28,22,18,68,23
1854,숙박,이린펜션,제주특별자치도 서귀포시 일주서로43번길 5,31,25,14,70,23
2657,음식점,명도암수다뜰,제주특별자치도 제주시 명림로 164,21,27,20,68,23
3493,음식점,지상에 별두개,제주시 애월읍 애월해안로 926,23,33,13,69,23
2524,음식점,딕시,제주특별자치도 서귀포시 일주동로 8592,26,30,14,70,23
2611,음식점,만강촌옛날칼국수,제주특별자치도 제주시 월랑로 42,36,24,9,69,23
3692,음식점,파라토도스,제주특별자치도 제주시 한림읍 금능길 87,37,20,13,70,23
3768,음식점,한양식당,제주특별자치도 서귀포시 이어도로 684,23,22,24,69,23
2639,음식점,매일통닭,제주특별자치도 서귀포시 중앙로54번길 35,32,24,12,68,23
2592,음식점,마라도별장식당,제주특별자치도 서귀포시 대정읍 마라로101번길 43,23,24,21,68,23
2650,음식점,메종드쁘티푸르,제주특별자치도 제주시 신설로7길 3,25,26,17,68,23
2596,음식점,마라톤식당,제주특별자치도 제주시 서광로 174,25,22,22,69,23
2507,음식점,동북왕,제주특별자치도 제주시 사장1길 43,22,27,19,68,23
2539,음식점,라온베이커리 남녕점,제주특별자치도 제주시 남녕로 11,23,27,18,68,23
2498,음식점,돔베돈,제주특별자치도 제주시 관덕로15길 25,29,27,14,70,23
2789,음식점,베이커리 포그,제주특별자치도 제주시 아란7길 10,23,30,17,70,23
2873,음식점,빵귿,제주특별자치도 제주시 구남동6길 45-1,38,16,14,68,23
2541,음식점,라운지엑스 애월점,제주특별자치도 제주시 애월읍 천덕로 880-24 A동 B1,26,24,20,70,23
2935,음식점,서서방 숯불닭갈비,제주특별자치도 제주시 신광로 61,36,23,9,68,23
1859,숙박,이찌마루&잠비,제주특별자치도 제주시 구좌읍 월정1길 54-11,20,29,19,68,23
1340,숙박,남쪽나라빌,제주특별자치도 서귀포시 천제연로 133-1,23,26,19,68,23
1868,숙박,저스트슬립제주,제주특별자치도 서귀포시 대정읍 무릉중앙로21번길 158-28,20,26,23,69,23
1863,숙박,일출썬 펜션,제주특별자치도 서귀포시 성산읍 성산중앙로 67,21,28,20,69,23
3721,음식점,피노,제주특별자치도 제주시 애월읍 유수암로 103,22,27,19,68,23
3079,음식점,싱싱잇,제주특별자치도 제주시 한림읍 한림로 181,38,16,12,66,22
2900,음식점,살랑살랑샤브샤브,제주특별자치도 제주시 서해안로 612,32,24,9,65,22
1434,숙박,디셈버호텔,제주특별자치도 제주시 삼무로1길 15,18,24,23,65,22
3629,음식점,커피스케치,제주특별자치도 서귀포시 안덕면 사계남로216번길 24-32,21,33,13,67,22
2511,음식점,동해루,제주특별자치도 제주시 추자면 추자로 58-1,23,21,23,67,22
1400,숙박,더오라,제주특별자치도 제주시 동성길 36-1 3층,20,27,19,66,22
3051,음식점,슬로우카페,제주특별자치도 서귀포시 표선면 일주동로 6470,20,22,24,66,22
1288,숙박,골든파크호텔,제주특별자치도 제주시 서광로2길 9,16,33,16,65,22
3166,음식점,에프터글로우,제주특별자치도 제주시 간월동로 67-3,25,30,12,67,22
2909,음식점,삼보식당,제주특별자치도 서귀포시 중정로 25,25,24,18,67,22
2536,음식점,라 아바나,제주특별자치도 제주시 도근내길 28,17,24,25,66,22
3835,음식점,황금섬숯불갈비,제주특별자치도 제주시 추자면 추자로 36,20,25,20,65,22
2355,음식점,난드르바당,제주특별자치도 서귀포시 하예하동로16번길 11-1,38,19,10,67,22
1512,숙박,모멘토호텔,제주특별자치도 서귀포시 태평로439번길 21,15,26,24,65,22
1537,숙박,밀레니엄빌,제주특별자치도 서귀포시 보목로64번길 196,22,24,20,66,22
3216,음식점,오캄,제주특별자치도 제주시 정실3길 118,18,24,24,66,22
3180,음식점,열공부엌,제주특별자치도 제주시 선덕로8길 26 비산쉐르빌 가동 103호,22,26,19,67,22
2477,음식점,돈마구이해장국(연동점),제주특별자치도 제주시 삼동길 60,22,27,17,66,22
2815,음식점,복여네왕돈가스,제주특별자치도 제주시 우도면 우도로 323,35,17,15,67,22
3670,음식점,탑해장국앤돈가스,제주특별자치도 제주시 신대로7길 7,23,22,22,67,22
1182,쇼핑,아꼬화,제주특별자치도 제주시 동광로 102,23,25,19,67,22
1118,쇼핑,구름두리,제주특별자치도 서귀포시 중정로61번길 20 1층 구름두리,24,17,26,67,22
3035,음식점,쉐프 이야기,제주특별자치도 제주시 연동4길 22,18,25,23,66,22
2284,음식점,구면카페,제주특별자치도 서귀포시 표선면 중산간동로5220번길 47,24,27,15,66,22
2563,음식점,루스트플레이스 구남점,제주특별자치도 제주시 도남로 199,30,26,10,66,22
3799,음식점,해주소반,"제주특별자치도 서귀포시 대정읍 글로벌에듀로 370 105호, 106호",32,20,14,66,22
3491,음식점,지미스천연아이스크림,제주특별자치도 제주시 우도면 우도해안길 1132,28,18,21,67,22
3322,음식점,이가,제주특별자치도 제주시 진군1길 17,20,21,25,66,22
1696,숙박,스톤성민박,제주특별자치도 서귀포시 일주서로 866,22,26,19,67,22
3734,음식점,하늘창고,제주특별자치도 제주시 조천읍 중산간동로 1301,26,22,18,66,22
3410,음식점,제주맛촌본점,제주특별자치도 제주시 서해안로 546,33,24,10,67,22
3349,음식점,일오삼가든,제주특별자치도 제주시 진남로8길 13,30,20,17,67,22
3347,음식점,일도 국수,제주특별자치도 제주시 삼성로 49,25,18,22,65,22
1818,숙박,올레관광호텔,제주특별자치도 제주시 서광로 254,29,22,16,67,22
3431,음식점,제주약수터 올레시장점,제주특별자치도 서귀포시 중앙로48번길 10,32,22,11,65,22
3364,음식점,잔디가미,제주특별자치도 제주시 우도면 우도해안길 912,31,19,17,67,22
3369,음식점,장인의집,제주특별자치도 제주시 애월읍 애월로19길 31,36,19,12,67,22
3423,음식점,제주설심당 본점,제주특별자치도 제주시 서해안로 504,24,28,13,65,22
3702,음식점,팜알로하,제주특별자치도 서귀포시 쇠소깍로 122,20,24,23,67,22
3742,음식점,하빌리스,제주시 전농로 37,24,32,11,67,22
1923,숙박,제주신신휴양펜션,제주특별자치도 서귀포시 안덕면 평화로319번길 133,20,29,16,65,22
3551,음식점,추억의 집,제주특별자치도 제주시 연삼로 414-1(이도이동),28,19,18,65,22
2627,음식점,맛나리,제주특별자치도 서귀포시 동문로 34 (서귀동),28,15,20,63,21
2510,음식점,동이트는집,제주특별자치도 제주시 신산로 71,27,25,12,64,21
3571,음식점,카페 깡,제주특별자치도 서귀포시 표선면 가시로565번길 18,23,29,12,64,21
2464,음식점,도남오거리 도남점,제주특별자치도 제주시 도남로6길 16,25,17,21,63,21
3132,음식점,야시장맛통령,제주특별자치도 제주시 관덕로14길 16,22,31,11,64,21
2801,음식점,보라네,제주특별자치도 제주시 추자면 추자로 96,21,27,15,63,21
1420,숙박,동백동산펜션,제주시 조천읍 북흘로 378,21,18,23,62,21
2720,음식점,미송식탁,제주특별자치도 제주시 삼무로11길 36,22,25,17,64,21
2304,음식점,그러므로part2,제주특별자치도 제주시 수목원길 16-14,20,28,15,63,21
2257,음식점,고벤져스(본점),제주특별자치도 제주시 신성로 66,18,28,16,62,21
2530,음식점,뚜르,제주특별자치도 서귀포시 표선면 가시로613번길 60,19,28,15,62,21
2203,음식점,60빈스,제주특별자치도 서귀포시 태평로120번길 29-2,30,17,15,62,21
2317,음식점,금보,제주특별자치도 제주시 서부두길 14,24,16,23,63,21
2178,숙박,호텔컬리넌제주,제주특별자치도 제주시 사장1길 26,23,18,21,62,21
2384,음식점,누옥,제주특별자치도 제주시 삼성로5길 21-1,22,20,22,64,21
3630,음식점,커피앤빵,제주특별자치도 제주시 추자면 추자로 58-1,23,25,16,64,21
2370,음식점,넘버 138,제주특별자치도 서귀포시 쇠소깍로 138,24,20,19,63,21
3648,음식점,큐티파이 카페,제주특별자치도 제주시 애월읍 애월해안로 610,26,20,17,63,21
2168,숙박,호텔 캘리포니아 제주,제주특별자치도 서귀포시 김정문화로27번길 14-4,14,24,24,62,21
1481,숙박,루미수다게스트하우스,제주특별자치도 제주시 중앙로 192,21,25,16,62,21
3165,음식점,에이팩토리 커피앤북스,제주시 탑동로 11,17,34,13,64,21
3647,음식점,쿡이야,제주특별자치도 제주시 애월읍 고내로7길 44,22,21,19,62,21
1375,숙박,단빌리지게스트하우스,제주특별자치도 제주시 한경면 고락로 100,17,31,14,62,21
3078,음식점,심봉사눈뜬톳해물짜장짬뽕,제주특별자치도 서귀포시 대정읍 마라로 43,23,21,20,64,21
3167,음식점,에피소드,제주특별자치도 제주시 한경면 고조로 62,20,21,21,62,21
3086,음식점,아꼬떼카페,제주특별자치도 제주시 조천읍 선교로 548,21,29,12,62,21
2938,음식점,서울떡볶이,제주특별자치도 제주시 동문로4길 11,29,18,17,64,21
3424,음식점,제주순풍해장국노형점,제주특별자치도 제주시 진군남4길 7-8,23,29,10,62,21
3846,음식점,후년하우스,제주특별자치도 제주시 삼봉로 12,25,24,15,64,21
3489,음식점,지꺼진밥상,제주특별자치도 제주시 어영길 45-6,25,14,25,64,21
3439,음식점,제주와함께라면,제주특별자치도 제주시 애월읍 애월해안로 274,28,23,12,63,21
2030,숙박,탑팰리스호텔,제주특별자치도 제주시 중앙로 34,21,28,15,64,21
1247,숙박,For 安(포안),제주특별자치도 제주시 한림읍 옹포2길 12,18,28,17,63,21
1202,쇼핑,인연의숲,제주특별자치도 제주시 구좌읍 종달로5길 17,21,17,25,63,21
2800,음식점,보노리미니,제주시 조천읍 조함해안로 504,22,25,16,63,21
3354,음식점,일품순두부 연동점,제주특별자치도 제주시 도령로 64,33,20,9,62,21
1638,숙박,삼보민박,제주특별자치도 제주시 한림읍 명월성로 627,22,20,22,64,21
3205,음식점,오로라식당,제주특별자치도 제주시 우도면 우도로 174 농협 건너편,22,21,21,64,21
3186,음식점,예소담,제주특별자치도 제주시 천수로 6,24,26,14,64,21
1751,숙박,아템파우제,제주특별자치도 제주시 한림읍 월림8길 21,22,22,18,62,21
2819,음식점,볼스프로덕션,제주특별자치도 서귀포시 일주서로 626,28,19,15,62,21
1507,숙박,메이저호텔,제주특별자치도 제주시 사장3길 36,14,25,23,62,21
2699,음식점,무진장식당,제주특별자치도 제주시 서광로2길 11-9,20,25,17,62,21
2393,음식점,다가미 애월점,제주특별자치도 제주시 애월읍 평화로 2901-1,26,19,14,59,20
3809,음식점,헬로우우도,제주특별자치도 제주시 우도면 우도해안길 218,19,24,17,60,20
1914,숙박,제주사랑 펜션,제주특별자치도 서귀포시 태평로442번길 21,20,24,15,59,20
1244,숙박,521 게스트 하우스,제주특별자치도 제주시 애월읍 중용길 52-1 (신엄리) 521 게스트 하우스,18,24,18,60,20
1469,숙박,레지나팬션,제주특별자치도 서귀포시 이어도로 789,19,23,18,60,20
3143,음식점,어머니의뜻을담다 단지,제주특별자치도 제주시 애월읍 하귀2길 66,18,22,20,60,20
1991,숙박,초록새록,제주특별자치도 제주시 애월읍 중엄1길 37-22,28,17,14,59,20
2995,음식점,솔리브레,제주특별자치도 제주시 서해안로 512,15,21,24,60,20
2065,숙박,펜션연리,제주특별자치도 서귀포시 논짓물로48번길 3,20,25,16,61,20
3017,음식점,숙성도,제주특별자치도 제주시 원노형로 41,23,20,16,59,20
1936,숙박,제주와요펜션,제주특별자치도 제주시 조천읍 조천남4길 4,29,19,11,59,20
2053,숙박,파크사이드호텔,제주특별자치도 제주시 도령로 126,14,29,18,61,20
2236,음식점,갯마을,제주특별자치도 제주시 연동4길 6-2,15,23,23,61,20
1196,쇼핑,올레바다,제주특별자치도 서귀포시 이어도로 903-1,22,18,21,61,20
2553,음식점,레터스 투 시리얼,제주특별자치도 제주시 서해안로 210,26,22,11,59,20
3159,음식점,엉클망고,제주특별자치도 제주시 우도면 우도해안길 342,20,28,12,60,20
1611,숙박,비비엔다,제주특별자치도 제주시 구좌읍 세화11길 18,16,24,20,60,20
1804,숙박,오렌지트리 호텔,제주특별자치도 제주시 관덕로8길 7-12,23,25,13,61,20
2557,음식점,로빙화,제주특별자치도 서귀포시 남원읍 남태해안로 13,32,18,11,61,20
1231,쇼핑,풍년상회,제주특별자치도 제주시 조천읍 신북로 220,14,27,19,60,20
3553,음식점,추자북경,제주특별자치도 제주시 추자면 신양서길 13-9,27,17,16,60,20
2727,음식점,미쿠니,제주특별자치도 제주시 서흘길 41,22,19,19,60,20
2735,음식점,바농,서귀포시 이중섭로 19,17,21,22,60,20
2725,음식점,미인계 카페,제주특별자치도 제주시 애월읍 금성1길 29-1,21,20,19,60,20
2573,음식점,루스트플레이스 칠성로점,제주특별자치도 제주시 중앙로7길 3,25,24,10,59,20
2777,음식점,백리향,제주특별자치도 제주시 조천읍 신북로 244,28,16,17,61,20
1711,숙박,심스호텔,제주특별자치도 제주시 임항로 249,20,28,12,60,20
1282,숙박,고려민박,제주특별자치도 제주시 추자면 영흥4길 66,19,24,17,60,20
2516,음식점,두루김밥,제주특별자치도 제주시 정존5길 36,27,14,20,61,20
2562,음식점,룡천왕갈비탕,제주특별자치도 제주시 공설로 23,28,16,16,60,20
1205,쇼핑,제이어스,제주특별자치도 제주시 중앙로 217,17,27,16,60,20
3467,음식점,종이비행기,제주특별자치도 제주시 구좌읍 해맞이해안로 1446,14,23,20,57,19
2974,음식점,성춘(토종순대),제주특별자치도 제주시 성지로 68 (일도2동),33,13,12,58,19
3535,음식점,청도해물탕,제주특별자치도 제주시 서해안로 546,24,19,13,56,19
1727,숙박,씨제이 관광호텔,제주특별자치도 제주시 광양8길 24,27,20,9,56,19
2395,음식점,다니쉬,제주특별자치도 제주시 조천읍 함덕16길 56,24,19,13,56,19
2848,음식점,블랑제리,제주특별자치도 서귀포시 동홍중앙로52번길 2,24,20,12,56,19
3314,음식점,유심이감성찜닭,제주특별자치도 제주시 추자면 추자로 78,24,13,19,56,19
2642,음식점,맨도롱해장국,제주특별자치도 서귀포시 태평로353번길 11,25,13,19,57,19
1813,숙박,오션패밀리호텔,제주특별자치도 제주시 일주서로 7531,21,20,16,57,19
2621,음식점,만세국수 본점,제주특별자치도 제주시 오라로 152,25,22,10,57,19
1798,숙박,예스준게스트하우스,제주특별자치도 제주시 서해안로 232 (도두일동),22,23,13,58,19
2442,음식점,대향연탄구이,제주특별자치도 서귀포시 태평로 407,23,18,17,58,19
3765,음식점,한밭식당,제주특별자치도 제주시 추자면 대서3길 21,20,25,11,56,19
1714,숙박,썬베이펜션,제주특별자치도 제주시 서흘길 14,23,24,9,56,19
3204,음식점,오라오거리정식,제주시 서광로 103,19,28,11,58,19
1848,숙박,유창민박,제주특별자치도 제주시 추자면 추자로 46-1,21,19,18,58,19
2721,음식점,미스틱3도,제주특별자치도 제주시 1100로 2894-49 1층,29,17,11,57,19
3833,음식점,환상의짜장,제주특별자치도 서귀포시 대정읍 마라로 45,29,14,13,56,19
2500,음식점,동그라미식육식당(돈델리),제주특별자치도 서귀포시 1100로 217,18,21,17,56,19
2631,음식점,맛좋은디,제주특별자치도 제주시 구좌읍 세평항로 47,19,17,20,56,19
3748,음식점,하원가흑돼지,제주특별자치도 서귀포시 이어도로 278,19,21,14,54,18
3537,음식점,청정고을식당,제주특별자치도 제주시 추자면 대서1길 6,15,18,20,53,18
2733,음식점,바?식당,제주특별자치도 서귀포시 남원읍 태위로 87,53,0,0,53,18
2416,음식점,달빛머금은카페,제주특별자치도 제주시 중앙로3길 17,23,20,12,55,18
2578,음식점,리솔라 무인카페,제주특별자치도 서귀포시 성산읍 서성일로 730,21,23,9,53,18
2058,숙박,팜힐,제주특별자치도 서귀포시 예래로 107,17,23,13,53,18
2724,음식점,미원,제주특별자치도 제주시 원노형6길 10,19,24,12,55,18
3719,음식점,프로젝트 064,제주특별자치도 제주시 신광로4길 13,21,15,17,53,18
2711,음식점,미나리(제주시),제주특별자치도 제주시 삼무로11길 34,16,25,13,54,18
3610,음식점,카페인우도,제주특별자치도 제주시 우도면 우도해안길 1040,18,21,16,55,18
2162,숙박,호텔 더블유 신제주점(hotel W),제주특별자치도 제주시 은남4길 42,20,21,12,53,18
1329,숙박,나무이야기 하우스,제주특별자치도 서귀포시 표선면 민속해안로 32,17,27,10,54,18
1743,숙박,아이존호텔,제주특별자치도 제주시 신광로4길 18,24,25,6,55,18
3346,음식점,인풍감자탕,제주특별자치도 제주시 만덕로 36,27,21,7,55,18
1992,숙박,초록하우스,제주특별자치도 제주시 한림읍 명재로 17,22,18,14,54,18
1689,숙박,스카이리더스호텔,제주특별자치도 제주시 신광로 106,21,24,9,54,18
3094,음식점,아모르키친,제주특별자치도 서귀포시 표선면 표선동서로 221,17,17,19,53,18
3421,음식점,제주서문수산,제주특별자치도 제주시 서문로4길 13-2,55,0,0,55,18
3199,음식점,오동여식당,제주특별자치도 제주시 추자면 추자로 20,21,15,18,54,18
3240,음식점,왓섬,제주특별자치도 제주시 오등4길 3,23,15,17,55,18
1752,숙박,아토하우스,제주특별자치도 서귀포시 남원읍 신흥앞동산로 84,16,21,16,53,18
1328,숙박,나무이야기,제주특별자치도 서귀포시 남원읍 남한로21번길 9,21,25,9,55,18
2683,음식점,모이세해장국 노형점,제주특별자치도 제주시 월랑로 61,19,22,12,53,18
2603,음식점,마모루,제주특별자치도 제주시 광양13길 10-1,18,21,14,53,18
3525,음식점,천금반점,제주특별자치도 제주시 북성로 7 1층,25,16,14,55,18
2412,음식점,달리다방,제주특별자치도 제주시 구좌읍 해맞이해안로 2326,20,16,18,54,18
1637,숙박,삼다펜션,제주특별자치도 제주시 서해안로 456-6,18,21,13,52,17
3039,음식점,쉬멍가,제주특별자치도 서귀포시 중정로73번길 11,20,14,16,50,17
2731,음식점,민봉태중화요리,제주특별자치도 제주시 연삼로 776 (화북이동),19,18,13,50,17
2151,숙박,해호텔,제주특별자치도 제주시 서해안로 526,20,23,9,52,17
2431,음식점,대독장(제주본점),제주특별자치도 제주시 연북로 212,23,18,9,50,17
2821,음식점,봉?망고,제주특별자치도 제주시 구좌읍 월정7길 62-1,52,0,0,52,17
3050,음식점,스피닝울프,제주특별자치도 서귀포시 성산읍 동류암로 20,24,13,14,51,17
3663,음식점,탐라가든,제주특별자치도 제주시 서사로 51,17,17,16,50,17
2294,음식점,국제부두토산품스낵,제주특별자치도 제주시 임항로 191,15,24,12,51,17
2547,음식점,레드브라운,제주특별자치도 서귀포시 남원읍 태위로 268,14,19,19,52,17
3269,음식점,우리회수산,제주특별자치도 제주시 동문로2길 10,19,17,16,52,17
2285,음식점,구이향연동점,제주특별자치도 제주시 연북로 68,20,21,11,52,17
3622,음식점,카페힐스,제주특별자치도 제주시 추자면 신양4길 18,20,18,14,52,17
2888,음식점,산내들식당,제주특별자치도 제주시 서광로4길 16,22,17,13,52,17
3798,음식점,해조네,제주특별자치도 서귀포시 안덕면 대평감산로 12,28,11,11,50,17
1902,숙박,제주마실게스트하우스,제주특별자치도 제주시 서광로2길 11-16,17,21,13,51,17
2587,음식점,마농오메기통닭마농문어통닭,제주특별자치도 서귀포시 중정로61번길 20,24,16,10,50,17
2028,숙박,탐라누리,제주특별자치도 서귀포시 성산읍 금백조로 68,19,22,11,52,17
3738,음식점,하르방짬뽕,제주특별자치도 제주시 애월읍 하귀동남4길 4,25,15,12,52,17
3153,음식점,어제보다오늘,제주특별자치도 제주시 서해안로 68,21,18,13,52,17
2568,음식점,루스트플레이스 시청점,제주특별자치도 제주시 중앙로 230-1,17,19,14,50,17
1305,숙박,그림리조트,제주특별자치도 제주시 서해안로 620-1 (용담삼동),20,14,18,52,17
1872,숙박,제니아호텔,제주특별자치도 제주시 은남1길 25,22,19,9,50,17
3746,음식점,하우스142,제주특별자치도 제주시 오광로 142,21,17,10,48,16
1784,숙박,엘마르게스트하우스,제주특별자치도 서귀포시 표선면 표선당포로 17,17,16,16,49,16
1787,숙박,엠버리조트,제주특별자치도 제주시 1100로 2671-51,19,17,11,47,16
3701,음식점,팜스테이블,제주특별자치도 제주시 수목원길 41,14,18,17,49,16
3767,음식점,한성오메기떡,제주특별자치도 제주시 동문로4길 9-2,30,12,5,47,16
2781,음식점,뱅인타코,제주특별자치도 서귀포시 대정읍 에듀시티로 74 상가동 101호,25,11,11,47,16
3502,음식점,진주식당,제주특별자치도 서귀포시 태평로 353,21,17,9,47,16
2641,음식점,맥파이 블루버드,제주특별자치도 제주시 탑동로2길 7,33,9,6,48,16
1425,숙박,동일민박,"제주특별자치도 제주시 추자면 대서1길 9, 3층",14,18,17,49,16
2606,음식점,마실디,제주특별자치도 서귀포시 중정로73번길 16,18,17,12,47,16
1616,숙박,비앤비호텔,제주특별자치도 제주시 삼무로3길 48,17,24,8,49,16
2651,음식점,메종드쁘티푸르 노형점,제주특별자치도 제주시 노형8길 12,28,11,8,47,16
3108,음식점,안녕협재씨,제주특별자치도 제주시 한림읍 협재1길 55,16,19,12,47,16
2837,음식점,부원뚝배기,제주특별자치도 제주시 한림읍 일주서로 5608,19,16,13,48,16
3293,음식점,월리월리,제주특별자치도 제주시 구좌읍 월정1길 70-6,15,22,8,45,15
3616,음식점,카페탠저린,제주특별자치도 서귀포시 이어도로 880,21,14,11,46,15
3432,음식점,제주에가면,제주특별자치도 제주시 탑동로 119,21,12,11,44,15
3638,음식점,컴홈,제주특별자치도 제주시 노형6길 9,15,19,12,46,15
3720,음식점,플로렌스,제주특별자치도 제주시 추자면 추자로 30-2,16,15,14,45,15
2320,음식점,긍정동커피,제주특별자치도 서귀포시 중정로 34 천지연 리슈빌 102호 긍정동커피,20,13,11,44,15
2648,음식점,메종드베니,제주특별자치도 제주시 동화로 28,17,17,12,46,15
3065,음식점,신등대수산회센타,제주특별자치도 제주시 추자면 추자로 12,17,12,15,44,15
2951,음식점,섬타르,제주특별자치도 제주시 다랑곶1길 9,19,14,13,46,15
3112,음식점,알라스카인제주 용담점,제주특별자치도 제주시 서해안로 468-2,16,21,9,46,15
1464,숙박,런호텔,제주특별자치도 서귀포시 태평로431번길 20,18,13,15,46,15
1527,숙박,미래하우스,제주특별자치도 제주시 서해안로 224-10,13,17,16,46,15
1214,쇼핑,제주소랑,제주특별자치도 제주시 한림읍 명상로 19,14,16,16,46,15
1176,쇼핑,손끝에서,제주특별자치도 제주시 구좌읍 구좌로 33-11,16,16,13,45,15
1147,쇼핑,미앤제주,제주특별자치도 제주시 한림읍 광산로 942,12,19,10,41,14
3246,음식점,용담생국수,제주특별자치도 제주시 용담로 95,18,14,11,43,14
1232,쇼핑,프레쉬모먼트,제주특별자치도 제주시 인다2길 8,18,10,13,41,14
3427,음식점,제주시새우리 제주점,제주특별자치도 제주시 무근성7길 24,25,7,9,41,14
1129,쇼핑,더솜라탄,제주특별자치도 제주시 노형1길 8-9,18,9,16,43,14
2552,음식점,레이지펌프,제주특별자치도 제주시 애월읍 애월북서길 32,22,10,9,41,14
1919,숙박,제주쉼표,제주특별자치도 제주시 서해안로 504,17,16,9,42,14
1898,숙박,제주를여행하는히치하이커를위한안내소,제주특별자치도 제주시 용마로4길 5,18,16,9,43,14
3367,음식점,장수해장국,제주특별자치도 서귀포시 신서귀로51번길 11,16,13,14,43,14
3761,음식점,한량2010,제주특별자치도 제주시 광양13길 12-2,13,16,13,42,14
2537,음식점,라쁠라주,제주특별자치도 제주시 서해안로 518,15,17,11,43,14
2823,음식점,봉골레밥상,제주특별자치도 제주시 추자면 대서3길 40,18,10,15,43,14
3550,음식점,추가네,제주특별자치도 제주시 서사로 176(오라일동),14,15,13,42,14
2580,음식점,리치망고 도두해안로점,제주특별자치도 제주시 서해안로 191,17,14,10,41,14
3391,음식점,제원분식,제주특별자치도 제주시 신광로6길 2,15,18,9,42,14
3769,음식점,한옥집,제주특별자치도 서귀포시 서홍로 41,19,9,10,38,13
1690,숙박,스카이워커,제주특별자치도 제주시 관덕로13길 11,21,17,2,40,13
2439,음식점,대춘해장국 노형점,제주특별자치도 제주시 원노형로 11,26,11,2,39,13
2479,음식점,돈사촌,제주특별자치도 제주시 서사로 7,22,6,11,39,13
2241,음식점,게판5분전,제주특별자치도 서귀포시 중앙로54번길 35,18,11,9,38,13
2867,음식점,빅토리아,제주특별자치도 제주시 서해안로 268,16,13,10,39,13
2980,음식점,세이? 칠성로점,"제주특별자치도 제주시 관덕로11길 35, 2층",38,0,0,38,13
3170,음식점,엠츄로,제주특별자치도 제주시 은남4길 46,14,11,14,39,13
3244,음식점,용꽈배기,제주특별자치도 제주시 서광로30길 3,16,9,14,39,13
2261,음식점,고씨네천지국수,제주특별자치도 서귀포시 중앙로79번길 4,18,10,9,37,12
2982,음식점,세컨드밀,제주특별자치도 제주시 남성로4길 3,14,11,10,35,12
2737,음식점,바다가는길,제주특별자치도 서귀포시 남성중로 40,21,12,4,37,12
3425,음식점,제주스,제주특별자치도 제주시 동문로 4 1호,16,9,11,36,12
3561,음식점,친절한비자씨,제주특별자치도 제주시 구좌읍 비자숲길 58,14,12,10,36,12
3172,음식점,연동길,제주특별자치도 제주시 은남2길 23,12,14,9,35,12
2391,음식점,니모메빈티지라운지,제주특별자치도 제주시 일주서로 7335-8,16,12,7,35,12
3329,음식점,이맛,제주특별자치도 제주시 추자면 추자로 24-5,15,9,11,35,12
3586,음식점,카페록록,제주특별자치도 제주시 구좌읍 하도서문길 41,14,12,11,37,12
3640,음식점,코너스윗,제주특별자치도 제주시 제원길 14,13,15,9,37,12
2607,음식점,마음카페,제주특별자치도 서귀포시 표선면 녹산로 381-15,10,20,6,36,12
2007,숙박,케니스토리 인 서귀포,제주특별자치도 서귀포시 동문로 42,11,10,12,33,11
3673,음식점,태산봉해장국,제주특별자치도 제주시 성지로 67-1,14,11,9,34,11
2543,음식점,라토커피,제주특별자치도 제주시 광양10길 20,12,14,8,34,11
3384,음식점,제니의정원,제주특별자치도 제주시 명주길 26-12,9,15,10,34,11
2572,음식점,루스트플레이스 제원점,제주특별자치도 제주시 노연로 118-1,9,15,10,34,11
3301,음식점,웰덤대게고로케 올레시장점,제주특별자치도 서귀포시 중정로73번길 13,16,12,4,32,11
3581,음식점,카페나모나모,제주특별자치도 제주시 도두봉6길 4,14,9,9,32,11
2475,음식점,돈가,제주특별자치도 제주시 문송길 36,15,13,6,34,11
3036,음식점,쉐프의스시이야기,제주특별자치도 제주시 신광로 36,16,8,8,32,11
1786,숙박,엠버관광호텔,제주특별자치도 제주시 삼무로 12 (연동),10,14,6,30,10
3304,음식점,윈드스톤,제주특별자치도 제주시 애월읍 광성로 272,14,9,7,30,10
3534,음식점,청담집,제주특별자치도 제주시 월랑로 83,15,9,3,27,9
1123,쇼핑,농업회사법인(주)제주왕지케,제주특별자치도 제주시 한경면 고산로2길 22-13 (고산리) 1층,27,0,0,27,9
3495,음식점,지중해그릴,제주특별자치도 제주시 관덕로15길 11-1(일도일동),9,11,7,27,9
2329,음식점,김서방재첩해장국,제주특별자치도 제주시 원노형6길 27,10,11,5,26,9
3348,음식점,일도국수,제주특별자치도 제주시 삼성로 49,12,7,8,27,9
3705,음식점,펠릭스,제주특별자치도 서귀포시 일주동로 8835-16,14,8,4,26,9
2979,음식점,세이? 시청점,제주특별자치도 제주시 서광로32길 34,24,0,0,24,8
1188,쇼핑,안온점,제주특별자치도 제주시 한림읍 한림로 492 (옹포리) 2층,18,0,0,18,6
1720,숙박,씨스테이 리틀해녀 블루,제주특별자치도 제주시 용마로4길 15,16,0,0,16,5
1073,관광지,해적잠수함,제주특별자치도 제주시 한경면 노을해안로 1146,1,2,2,5,2
934,관광지,지니어스 로사이,제주특별자치도 서귀포시 성산읍 고성리 21,1,1,0,2,1
1157,쇼핑,본,제주특별자치도 제주시 신광로 27,1,0,2,3,1
13,관광지,____[삭제],제주특별자치도 제주시 조천읍 번영로 1218 (대흘리) 제주옹기정원 야원,4,0,0,4,1
251,관광지,마린파크,제주특별자치도 서귀포시 안덕면 화순중앙로 132,3,1,0,4,1
3531,음식점,천해천,제주특별자치도 제주시 한라대학로 25,3,0,0,3,1
250,관광지,마라도잠수함,제주특별자치도 서귀포시 안덕면 형제해안로 13,2,0,0,2,1
2231,음식점,갓포하루,제주특별자치도 서귀포시 중문상로 46 1층,1,0,1,2,1
1782,숙박,에프원모텔,제주특별자치도 제주시 사장1길 18,1,0,0,1,0
2306,음식점,그리다시카고피자&파스타,제주특별자치도 제주시 서광로32길 14,1,0,0,1,0
1427,숙박,동해모텔,제주특별자치도 제주시 서사로 182,1,0,0,1,0
3217,음식점,오쿠다,제주특별자치도 제주시 구남동4길 45,1,0,0,1,0
1681,숙박,숲속의궁전,제주특별자치도 서귀포시 염돈로28번길 46,1,0,0,1,0
3,관광지,1111,제주특별자치도 서귀포시 성산읍 일출로 284-12,1,0,0,1,0
1555,숙박,바르게스트하우스,제주특별자치도 제주시 한림읍 협재1길 17-1,1,0,0,1,0
617,관광지,어승생승마장 Horseland Jeju,제주특별자치도 제주시 1100로 2659 (노형동),1,0,0,1,0
358,관광지,북돌아진오름,제주특별자치도 제주시 애월읍 봉성리 산 41,1,0,0,1,0
214,관광지,동검은이오름(거미오름),제주특별자치도 제주시 구좌읍 종달리 산 70,1,0,0,1,0
